TitleAbrevated	Fulltitle
ABH. WESTFÄL. MUS. NAT.KD.	ABHANDLUNGEN AUS DEM WESTFÄLISCHEN MUSEUM FÜR NATURKUNDE
ABH. NAT.FORSCH. GES. ZÜR.	ABHANDLUNGEN DER NATURFORSCHENDEN GESELLSCHAFT IN ZÜRICH
ABH. NAT.WISS. VER. BREMEN	ABHANDLUNGEN DES NATURWISSENSCHAFTLICHEN VEREINS ZU BREMEN
ABSTR. BOT.	ABSTRACTA BOTANICA
ACADEMIA	ACADEMIA
ACS SYMP. SER.	ACS SYMPOSIUM SERIES
ACTA AGRAL. FENN.	ACTA AGRALIA FENNICA
ACTA AGRAR. SILV., SER. LESN. (KRAK.)	ACTA AGRARIA ET SILVESTRIA, SERIA LESNA, KRAKAU
ACTA ANAT.	ACTA ANATOMICA
ACTA ARCHAEOL.	ACTA ARCHAEOLOGICA
ACTA BERN.	ACTA BERNENSIA
ACTA BIOL. EXP.	ACTA BIOLOGIAE EXPERIMENTALIS
ACTA BIOL. CRACOVIENSIA SER. BOT.	ACTA BIOLOGICA CRACOVIENSIA SERIES BOTANICA
ACTA BIOL. MONT.	ACTA BIOLOGICA MONTANA
ACTA BOT. ACAD. SCI. HUNG.	ACTA BOTANICA ACADEMIAE SCIENTIARUM HUNGARICAE
ACTA BOT. FENN.	ACTA BOTANICA FENNICA
ACTA BOT. HUNG.	ACTA BOTANICA HUNGARICA
ACTA BOT. NEERL.	ACTA BOTANICA NEERLANDICA
ACTA BOT. YUNNANICA	ACTA BOTANICA YUNNANICA
ACTA BOT. BOREAL- OCCIDENT SIN.	ACTA BOTANY BOREAL-OCCIDENT SINICA
ACTA CHIROPTEROLOGICA	ACTA CHIROPTEROLOGICA
ACTA ECOL. SIN.	ACTA ECOLOGICA SINICA
ACTA FAUN. ENTOMOL. MUS. NATL. PRAGAE	ACTA FAUNISTICA ENTOMOLOGICA MUSEI NATIONALIS PRAGAE
ACTA FOR. FENN.	ACTA FORESTALIA FENNICA
ACTA GEOGR. SIN.	ACTA GEOGRAPHICA SINICA
ACTA GEOPHYS.	ACTA GEOPHYSICA
ACTA HORTIC.	ACTA HORTICULTURAE
ACTA HYDROBIOL. SIN.	ACTA HYDROBIOLOGICA SINICA
ACTA HYDROPHYS.	ACTA HYDROPHYSICA
ACTA INST. FOR. ZVOLEN.	ACTA INSTITUTI FORESTALIS ZVOLENENSIS
ACTA JUTL.	ACTA JUTLANDICA
ACTA MATER.	ACTA MATERIALIA
ACTA OECOL.	ACTA OECOLOGICA
ACTA ORNITHOL.	ACTA ORNITHOLIGICA
ACTA PALAEOBOT.	ACTA PALAEOBOTANICA
ACTA PALAEONTOL.	ACTA PALAEONTOLOGICA
ACTA PHYTOGEOGR. SUEC.	ACTA PHYTOGEOGRAPHICA SUECICA
ACTA PHYTOMED.	ACTA PHYTOMEDICA
ACTA PHYTOPATHOL. ENTOMOL. HUNG.	ACTA PHYTOPATHOLOGICA ET ENTOMOLOGICA HUNGARICA
ACTA PROTOZOOL.	ACTA PROTOZOOLOGICA
ACTA SCI. NAT. ACAD. SCI. BOHEMOSLOV.	ACTA SCIENTIARUM NATURALIUM ACADEMIAE SCIENTIARUM BOHEMOSLOVACA
ACTA SOC. BOT. POL.	ACTA SOCIETATIS BOTANICORUM POLONIAE
ACTA SOC. FAUNA FLORA FENN.	ACTA SOCIETATIS PRO FAUNA ET FLORA FENNICA
ACTA THERIOL.	ACTA THERIOLOGICA
ACTA UNIV. CAROL. BIOL.	ACTA UNIVERSITATIS CAROLINAE BIOLOGICA
ACTA ZOOL. CRACOV.	ACTA ZOOLOGICA CRAKOVIENSIA
ACTA ZOOL. FENN.	ACTA ZOOLOGICA FENNICA
ACTA ZOOL. HUNG.	ACTA ZOOLOGICA HUNGARICA
ACTA ZOOL. LITUAN.	ACTA ZOOLOGICA LITUANICA
ACTES SOC. HELV. SCI. NAT.	ACTES DE LA SOCIÉTÉ HELVÉTIQUE DES SCIENCES NATURELLES
ACTES SOC. JURA. ÉMUL.	ACTES DE LA SOCIÉTÉ JURASSIENNE D'ÉMULATION
ADAPT. CLIM. CHANG. ALP. SPACE, ADAPTALP	ADAPTATION TO CLIMATE CHANGE IN THE ALPINE SPACE, ADAPTALP
ADV. AGRON.	ADVANCES IN AGRONOMY
ADV. ATMOS. SCI.	ADVANCES IN ATMOSPHERIC SCIENCES
ADV. CHEM. SER.	ADVANCES IN CHEMISTRY SERIES
ADV. ECOL. RES.	ADVANCES IN ECOLOGICAL RESEARCH
ADV. ETHOL.	ADVANCES IN ETHOLOGY
ADV. GEOSCI.	ADVANCES IN GEOSCIENCES
ADV. INSECT PHYSIOL.	ADVANCES IN INSECT PHYSIOLOGY
ADV. PLANT PATHOL.	ADVANCES IN PLANT PATHOLOGY
ADV. SPACE RES.	ADVANCES IN SPACE RESEARCH
ADV. WATER RESOUR.	ADVANCES IN WATER RESOURCES
AEOLIAN RES.	AEOLIAN RESEARCH
AEROSOL AIR QUAL. RES.	AEROSOL AND AIR QUALITY RESEARCH
AFR. J. SCI. TECHNOL. INNOV. DEV.	AFRICAN JOURNAL OF SCIENCE, TECHNOLOGY, INNOVATION AND DEVELOPMENT
AFZ/WALD	AFZ/DER WALD
AGRARFORSCHUNG	AGRARFORSCHUNG (AB 2010 NEU AGRARFORSCHUNG SCHWEIZ)
AGRARFORSCH. SCHWEIZ	AGRARFORSCHUNG SCHWEIZ (VOR 2010 AGRARFORSCHUNG)
AGRIC. TICIN.	AGRICOLTORE TICINESE
AGRIC. ITAL.	AGRICOLTURA ITALIANA
AGRIC. FOR. ENTOMOL.	AGRICULTURAL AND FOREST ENTOMOLOGY
AGRIC. FOR. METEOROL.	AGRICULTURAL AND FOREST METEOROLOGY
AGRIC. INF. BULL. USDA FOR. SERV.	AGRICULTURAL INFORMATION BULLETIN USDA FOREST SERVICE
AGRIC. METEOROL.	AGRICULTURAL METEOROLOGY
AGRIC. SYST.	AGRICULTURAL SYSTEMS
AGRIC. WATER MANAGE.	AGRICULTURAL WATER MANAGEMENT
AGRIC. ECOSYST. ENVIRON.	AGRICULTURE, ECOSYSTEMS AND ENVIRONMENT
AGRIC. HANDB.	AGRICULTURE HANDBOOK
AGRO-ECOSYST.	AGRO-ECOSYSTEMS
AGROFOR. SYST.	AGROFORESTRY SYSTEMS
AGRON. SUSTAINABLE DEV.	AGRONOMY FOR SUSTAINABLE DEVELOPMENT
AGRON. J.	AGRONOMY JOURNAL
ALLG. BOT. ZTG.	ALLGEMEINE BOTANISCHE ZEITUNG
ALLG. FORST- JAGDZTG.	ALLGEMEINE FORST- UND JAGDZEITUNG
ALLG. FORST Z. WALDWIRTSCH. UMWELTVORSORGE	ALLGEMEINE FORST ZEITSCHRIFT FÜR WALDWIRTSCHAFT UND UMWELTVORSORGE [AFZ-DER WALD]
ALLG. FORSTZTG. (WIEN)	ALLGEMEINE FORSTZEITUNG
ALLG. SCHWEIZ. MIL.Z.	ALLGEMEINE SCHWEIZERISCHE MILLITÄRZEITSCHRIFT
ALLIONIA	ALLIONIA
ALPEN	ALPEN
ALPES	ALPES
ALP. BOT.	ALPINE BOTANY
AL SERV. BOSCO PAESAGGIO	AL SERVIZIO DEL BOSCO E DEL PAESAGGIO
AMBIO	AMBIO
AMÉNAGE. TERRIT.	AMÉNAGEMENT DU TERRITOIRE
AM. ANTIQU.	AMERICAN ANTIQUITY
AM. J. AGRIC. ECON.	AMERICAN JOURNAL OF AGRICULTURAL ECONOMICS
AM. J. ARCHAEOL.	AMERICAN JOURNAL OF ARCHAEOLOGY
AM. J. BOT.	AMERICAN JOURNAL OF BOTANY
AM. J. COMMUNITY PSYCHOL.	AMERICAN JOURNAL OF COMMUNITY PSYCHOLOGY
AM. J. PHYSIOL.	AMERICAN JOURNAL OF PHYSIOLOGY
AM. J. POLIT. SCI.	AMERICAN JOURNAL OF POLITICAL SCIENCE
AM. J. PREV. MED.	AMERICAN JOURNAL OF PREVENTIVE MEDICINE
AM. J. PUBLIC HEALTH	AMERICAN JOURNAL OF PUBLIC HEALTH
AM. J. SCI.	AMERICAN JOURNAL OF SCIENCE
AM. MIDL. NAT.	AMERICAN MIDLAND NATURALIST
AM. MUS. NOVIT.	AMERICAN MUSEUM NOVITATES
AM. NAT.	AMERICAN NATURALIST
AM. POLIT. SCI. REV.	AMERICAN POLITICAL SCIENCE REVIEW
AM. PSYCHOL.	AMERICAN PSYCHOLOGIST
AM. ZOOL.	AMERICAN ZOOLOGIST
ANAL. CHIM. ACTA	ANALYTICA CHIMICA ACTA
ANAL. BIOANAL. CHEM.	ANALYTICAL AND BIOANALYTICAL CHEMISTRY
ANAL. BIOCHEM.	ANALYTICAL BIOCHEMISTRY
ANAL. CHEM.	ANALYTICAL CHEMISTRY
ANAT. ANZ.	ANATOMISCHER ANZEIGER
ANGEW. BOT.	ANGEWANDTE BOTANIK
ANGEW. ENTOMOL.	ANGEWANDTE ENTOMOLOGIE
ANGEW. LANDSCH.ÖKOL.	ANGEWANDTE LANDSCHAFTSÖKOLOGIE
ANGEW. PFLANZENSOZIOL.	ANGEWANDTE PFLANZENSOZIOLOGIE
ANIM. BEHAV.	ANIMAL BEHAVIOUR
ANIM. CONSERV.	ANIMAL CONSERVATION
ANIM. GENET.	ANIMAL GENETICS
ANIM. RES.	ANIMAL RESEARCH
ANIM. WELF.	ANIMAL WELFARE
ANLIEGEN NAT.	ANLIEGEN NATUR
ANN. METEOROL.	ANNALEN DER METEOROLOGIE
ANN. SCHWEIZ. METEOROL. ANST.	ANNALEN DER SCHWEIZERISCHEN METEOROLOGISCHEN ANSTALT
ANN. NAT.HIST. MUS. WIEN	ANNALEN DES NATURHISTORISCHEN MUSEUMS IN WIEN
ANN. ACAD. SCI. FENN.	ANNALES ACADEMIAE SCIENTIARUM FENNICAE
ANN. AGRON.	ANNALES AGRONOMIQUES
ANN. BOT. FENN.	ANNALES BOTANICI FENNICI
ANN. SOC. ENTOMOL. FR.	ANNALES DE LA SOCIÉTÉ ENTOMOLOGIQUE DE FRANCE
ANN. ÉC. NATL. EAUX FOR.	ANNALES DE LÉCOLE NATIONALE DES EAUX ET FORÊTS ET DE LA STATION DE RECHERCHES ET EXPÉRIENCES FORESTIÈRES
ANN. PHYTOPATHOL.	ANNALES DE PHYTOPATHOLOGIE
ANN. SCI. FOR.	ANNALES DES SCIENCES FORESTIÈRES
ANN. ENTOMOL. FENN.	ANNALES ENTOMOLOGICI FENNICI
ANN. HIST.-NAT. MUS. NATL. HUNG.	ANNALES HISTORICO-NATURALES MUSEI NATIONALIS HUNGARICI
ANN. SCI. UNIV. BESANCON BIOL. VEG.	ANNALES SCIENTIFIQUES DE LUNIVERSITÉ DE BESANCON, BIOLOGIE VÉGÉTALE
ANN. ZOOL. FENN.	ANNALES ZOOLOGICI FENNICI
ANN. ACCAD. ITAL. SCI. FOR.	ANNALI ACCADEMIA ITALIANA DI SCIENZE FORESTALI
ANN. SPER. AGRAR.	ANNALI DELLA SPERIMENTAZIONE AGRARIA
ANN. IST. SPER. SELVIC.	ANNALI DELLISTITUTO SPERIMENTALE PER LA SELVICOLTURA
ANN. IST. SPER. ASSEST. FOR. ALPIC.	ANNALI DELLISTITUTO SPERIMENTALE PER LASSESTAMENTO FORESTALE E PER LALPICOLTURA
ANN. AGRAR. SCI.	ANNALS OF AGRARIAN SCIENCE
ANN. APPL. BIOL.	ANNALS OF APPLIED BIOLOGY
ANN. BOT.	ANNALS OF BOTANY
ANN. FOR. SCI.	ANNALS OF FOREST SCIENCE
ANN. GLACIOL.	ANNALS OF GLACIOLOGY
ANN. MATH. STAT.	ANNALS OF MATHEMATICAL STATISTICS
ANN. STAT.	ANNALS OF STATISTICS
ANN. ASSOC. AM. GEOGR.	ANNALS OF THE ASSOCIATION OF AMERICAN GEOGRAPHERS
ANN. ENTOMOL. SOC. AM.	ANNALS OF THE ENTOMOLOGICAL SOCIETY OF AMERICA
ANN. INST. STAT. MATH.	ANNALS OF THE INSTITUE OF STATISTICAL MATHEMATICS
ANN. MO. BOT. GARD.	ANNALS OF THE MISSOURI BOTANICAL GARDEN
ANN. N. Y. ACAD. SCI.	ANNALS OF THE NEW YORK ACADEMY OF SCIENCES
ANN. TOUR. RES.	ANNALS OF TOURISM RESEARCH
ANNU. REV. EARTH PLANET. SCI. LETT.	ANNUAL REVIEW OF EARTH AND PLANETARY SCIENCE LETTERS
ANNU. REV. ECOL. SYST.	ANNUAL REVIEW OF ECOLOGY AND SYSTEMATICS
ANNU. REV. ECOL. EVOL. SYST.	ANNUAL REVIEW OF ECOLOGY, EVOLUTION, AND SYSTEMATICS
ANNU. REV. ENTOMOL.	ANNUAL REVIEW OF ENTOMOLOGY
ANNU. REV. GENET.	ANNUAL REVIEW OF GENETICS
ANNU. REV. PHYTOPATHOL.	ANNUAL REVIEW OF PHYTOPATHOLOGY
ANNU. REV. PLANT BIOL.	ANNUAL REVIEW OF PLANT BIOLOGY
ANNU. REV. PLANT PHYSIOL.	ANNUAL REVIEW OF PLANT PHYSIOLOGY
ANNU. REV. PSYCHOL.	ANNUAL REVIEW OF PSYCHOLOGY
ANTHOS	ANTHOS
ANTIPODE	ANTIPODE
ANTIQUA	ANTIQUA
ANZ. SCHÄDL.KD. PFLANZENSCHUTZ UMWELTSCHUTZ	ANZEIGER FÜR SCHÄDLINGSKUNDE, PFLANZENSCHUTZ, UMWELTSCHUTZ
AOB PLANTS	AOB PLANTS
APIDOLOGIE	APIDOLOGIE
APPL. PLANT SCI.	APPLICATIONS IN PLANT SCIENCES
APPL. ENVIRON. MICROBIOL.	APPLIED AND ENVIRONMENTAL MICROBIOLOGY
APPL. ANIM. BEHAV. SCI.	APPLIED ANIMAL BEHAVIOUR SCIENCE
APPL. ECOL. ABSTR.	APPLIED ECOLOGY ABSTRACTS
APPL. ENERGY	APPLIED ENERGY
APPL. GEOCHEM.	APPLIED GEOCHEMISTRY
APPL. GEOGR. DEV.	APPLIED GEOGRAPHY AND DEVELOPMENT
APPL. GEOGR.	APPLIED GEOGRAPHY
APP.. MICROBIOL. BIOTECHNOL.	APPLIED MICROBIOLOGY AND BIOTECHNOLOGY
APPL. OPT.	APPLIED OPTICS
APPL. PHYS. LETT.	APPLIED PHYSICS LETTERS
APPL. PSYCHOL. INT. REV.	APPLIED PSYCHOLOGY: AN INTERNTIONAL REVIEW
APPL. RADIAT. ISOT.	APPLIED RADIATION AND ISOTOPES
APPL. SOIL ECOL.	APPLIED SOIL ECOLOGY
APPL. SPAT. ANAL. POLICY	APPLIED SPATIAL ANALYSIS AND POLICY
APPL. STAT.	APPLIED STATISTICS
APPL. VEG. SCI.	APPLIED VEGETATION SCIENCE
AQUAT. BOT.	AQUATIC BOTANY
AQUAT. CONSERV. MAR. FRESHW. ECOSYS.	AQUATIC CONSERVATION MARINE AND FRESHWATER ECOSYSTEMS
AQUAT. GEOCHEM.	AQUATIC GEOCHEMISTRY
AQUAT. SCI.	AQUATIC SCIENCES
ARACHNOL. MITT.	ARACHNOLOGISCHE MITTEILUNGEN
ARBORIC. J.	ARBORICULTURAL JOURNAL
ARCHÄOL. SCHWEIZ	ARCHÄOLOGIE DER SCHWEIZ
ARCHÄOL. MITT. NORDWESTDTSCHL.	ARCHÄOLOGISCHE MITTEILUNGEN AUS NORWESTDEUTSCHLAND
ARCHÉOL. NEUCHÂTEL.	ARCHÉOLOGIE NEUCHÂTELOISE
ARCHI	ARCHI
ARCH. ENVIRON. CONTAM. TOXICOL.	ARCHIVES OF ENVIRONMENTAL CONTAMINATION AND TOXICOLOGY
ARCH. FORSTWES.	ARCHIV FÜR FORSTWESEN
ARCH. FORSTWES. LANDSCHAFTSÖKOL.	ARCHIV FÜR FORSTWESEN UND LANDSCHAFTSÖKOLOGIE
ARCH. HYDROBIOL.	ARCHIV FÜR HYDROBIOLOGIE
ARCH. METEOROL. GEOPHYS. BIOKLIMATOL., SER. B	ARCHIV FÜR METEOROLOGIE, GEOPHYSIK UND BIOKLIMATOLOGIE, SERIE B
ARCH. NAT.SCHUTZ LANDSCH.FORSCH.	ARCHIV FÜR NATURSCHUTZ UND LANDSCHAFTSFORSCHUNG
ARCH. SOC. ZOOL. BOT. FENN. VANAMO	ARCHIVUM SOCIETATIS ZOOLOGICAE BOTANICAE FENNICAE VANAMO
ARCT., ANTARC., ALP. RES.	ARCTIC, ANTARCTIC, AND ALPINE RESEARCH
ARDEA	ARDEA
AREALSTAT. SCHWEIZ	AREALSTATISTIK DER SCHWEIZ
ASIAN J. CONSERV. BIOL.	ASIAN JOURNAL OF CONSERVATION BIOLOGY
ASP. APPL. BIOL.	ASPECTS OF APPLIED BIOLOGY
ATMOS. CHEM. PHYS.	ATMOSPHERIC CHEMISTRY AND PHYSICS
ATMOS. ENVIRON.	ATMOSPHERIC ENVIRONMENT
ATMOS. RES.	ATMOSPHERIC RESEARCH
ATMOS. SCI. LETT.	ATMOSPHERIC SCIENCE LETTERS
AUGSBG. ÖKOL. SCHR.	AUGSBURGER ÖKOLOGISCHE SCHRIFTEN
AUK	AUK
AUSTRALAS. PLANT PATHOL.	AUSTRALASIAN PLANT PATHOLOGY
AUSTRAL ECOL.	AUSTRAL ECOLOGY
AUST. GEOGR.	AUSTRALIA GEOGRAPHER
AUST. FOR. RES.	AUSTRALIAN FOREST RESEARCH
AUST. J. BOT.	AUSTRALIAN JOURNAL OF BOTANY
AUST. J. ECOL.	AUSTRALIAN JOURNAL OF ECOLOGY
AUST. J. MAR. FRESHW. RES.	AUSTRALIAN JOURNAL OF MARINE AND FRESHWATER RESEARCH
AUST. J. SOIL RES.	AUSTRALIAN JOURNAL OF SOIL RESEARCH
AUST. J. ENVIRON. EDUC.	AUSTRALIEN JOURNAL OF ENVIRONMENTAL EDUCATION
AUSTRIAN J. EARTH SCI.	AUSTRIAN JOURNAL OF EARTH SCIENCES
AUSTRIAN J. FOR. SCI.	AUSTRIAN JOURNAL OF FOREST SCIENCE
AVALANCHE J.	AVALANCHE JOURNAL
AVALANCHE REV.	AVALANCHE REVIEW
AVIC. MAG.	AVICULTURAL MAGAZINE
BADEN. NEUJAHRSBL.	BADENER NEUJAHRSBLÄTTER
BALT. FOR.	BALTIC FORESTRY
BASIC APPL. ECOL.	BASIC AND APPLIED ECOLOGY
BASL. BEITR. GEOGR.	BASLER BEITRÄGE ZUR GEOGRAPHIE
BASL. BEITR. GESCH.WISS.	BASLER BEITRÄGE ZUR GESCHICHTSWISSENSCHAFT
BAUHINIA	BAUHINIA
BAUTECH. NAT.GEFAHREN	BAUTECHNIK UND NATURGEFAHREN
BAYER. LANDWIRTSCH. JAHRB.	BAYERISCHES LANDWIRTSCHAFTLICHES JAHRBUCH
BEHAV. ECOL. SOCIOBIOL.	BEHAVIOURAL ECOLOGY AND SOCIOBIOLOGY
BEHAV. ECOL.	BEHAVIOURAL ECOLOGY
BEIH. BOT. CENT.BL.	BEIHEFTE ZUM BOTANISCHEN CENTRALBLATT
BEIH. ANN. SCHWEIZ. METEOROL. ANST.	BEIHEFT ZU DEN ANNALEN DER SCHWEIZERISCHEN METEOROLOGISCHEN ANSTALT
BEIH. Z. SCHWEIZ. FORSTVER.	BEIHEFT ZU DEN ZEITSCHRIFTEN DES SCHWEIZ. FORSTVEREINS
BEIH. JAHRB. SCHWEIZ. NAT.FORSCH. GES.	BEIHEFT ZUM JAHRBUCH DER SCHWEIZERISCHEN NATURFORSCHENDEN GESELLSCHAFT
BEIH. NOVA HEDWIGIA	BEIHEFT ZU NOVA HEDWIGIA
BEIH. SCHWEIZ. Z. FORST.WES.	BEIHEFT ZUR SCHWEIZERISCHEN ZEITSCHRIFT FÜR FORSTWESEN
BEIH. Z. MYKOL.	BEIHEFT ZUR ZEITSCHRIFT FÜR MYKOLOGIE
BEITR. FORSTWIRTSCH.	BEITRÄGE FÜR DIE FORSTWIRTSCHAFT
BEITR. FORSTWIRTSCH. LANDSCH.ÖKOL.	BEITRÄGE FÜR FORSTWIRTSCHAFT UND LANDSCHAFTSÖKOLOGIE
BEITR. NAT.SCHUTZ SCHWEIZ	BEITRÄGE ZUM NATURSCHUTZ IN DER SCHWEIZ
BEITR. AVIFAUNA RHEINL.	BEITRÄGE ZUR AVIFAUNA DES RHEINLANDES
BEITR. BIOL. PFLANZEN	BEITRÄGE ZUR BIOLOGIE DER PFLANZEN
BEITR. GEOBOT. LANDESAUFN. SCHWEIZ	BEITRÄGE ZUR GEOBOTANISCHEN LANDESAUFNAHME DER SCHWEIZ
BEITR. GEOL. SCHWEIZ: HYDROL.	BEITRÄGE ZUR GEOLOGIE DER SCHWEIZ: HYDROLOGIE
BEITR. HYDROL. SCHWEIZ	BEITRÄGE ZUR HYDROLOGIE DER SCHWEIZ
BEITR. JAGD- WILDFORSCH.	BEITRÄGE ZUR JAGD- UND WILDFORSCHUNG
BEITR. KRYPTOGAMENFLORA SCHWEIZ	BEITRÄGE ZUR KRYPTOGAMENFLORA DER SCHWEIZ
BEITR. NAT.KDL. FORSCH. SÜDWESTDTSCHL.	BEITRÄGE ZUR NATURKUNDLICHEN FORSCHUNG IN SÜDWESTDEUTSCHLAND
BELG. J. BOT.	BELGIAN JOURNAL OF BOTANY
BELG. J. ZOOL.	BELGIAN JOURNAL OF ZOOLOGY
BERGUNDSTEIGEN	BERGUNDSTEIGEN
BER. AKAD. NAT.SCHUTZ LANDSCH.PFL.	BERICHTE DER AKADEMIE FÜR NATURSCHUTZ UND LANDSCHAFTSPFLEGE
BER. BAYER. BOT. GES.	BERICHTE DER BAYERISCHEN BOTANISCHEN GESELLSCHAFT
BER. BAYER. LANDESANST. WALD FORSTWIRTSCH.	BERICHTE DER BAYERISCHEN LANDESANSTALT FÜR WALD UND FORSTWIRTSCHAFT
BER. BOT.-ZOOL. GES. LIECHT.-SARGANS-WERDENBERG	BERICHTE DER BOTANISCH-ZOOLOGISCHEN GESELLSCHAFT LIECHTENSTEIN- SARGANS-WERDENBERG
BER. DTSCH. BOT. GES.	BERICHTE DER DEUTSCHEN BOTANISCHEN GESELLSCHAFT
BER. EIDGENÖSS. FORSCH.ANST. WALD SCHNEE LANDSCH.	BERICHTE DER EIDG. FORSCHUNGSANSTALT FÜR WALD, SCHNEE UND LANDSCHAFT
BER. NAT.FORSCH. GES. FREIBG. I.B.	BERICHTE DER NATURFORSCHENDEN GESELLSCHAFT FREIBURG IM BREISGAU
BER. REINHOLD-TÜXEN-GES.	BERICHTE DER REINHOLD-TÜXEN-GESELLSCHAFT
BER. SCHWEIZ. BOT. GES.	BERICHTE DER SCHWEIZERISCHEN BOTANISCHEN GESELLSCHAFT
BER. SCHWYZERISCHE NAT.FORSCH. GES.	BERICHTE DER SCHWYZERISCHEN NATURFORSCHENDEN GESELLSCHAFT
BER. ST.GALL. NAT.WISS. GES.	BERICHTE DER ST. GALLISCHEN NATURWISSENSCHAFTLICHEN GESELLSCHAFT
BER. VERS.ANST. WASSERBAU HYDROL. GLAZIOL. EIDGENÖSS. TECH. HOCHSCH. ZÜR.	BERICHTE DER VERSUCHSANSTALT FÜR WASSERBAU, HYDROLOGIE UND GLAZIOLOGIE AN DER EIDG. TECHNISCHEN HOCHSCHULE ZÜRICH
BER. VOGELWARTE HIDDENSEE	BERICHTE DER VOGELWARTE HIDDENSEE
BER. BUNDESAMT WASSER GEOL.	BERICHTE DES BUNDESAMTES FÜR WASSER UND GEOLOGIE
BER. DTSCH. WETTERD.	BERICHTE DES DEUTSCHEN WETTERDIENSTES
BER. FORSCH.ZENT. WALDÖKOSYST.	BERICHTE DES FORSCHUNGSZENTRUMS WALDÖKOSYSTEME
BER. GEOBOT. INST. EIDGENÖSS. TECH. HOCHSCH., STIFT. RÜBEL	BERICHTE DES GEOBOTANISCHEN INSTITUTES DER EIDG. TECHNISCHEN HOCHSCHULE, STIFTUNG RÜBEL
BER. EIDGENÖSS. ANST. FORSTL. VERS.WES.	BERICHTE EIDG. ANSTALT FÜR DAS FORSTLICHE VERSUCHSWESEN
BER. FREIBG. FORSTL. FORSCH.	BERICHTE FREIBURGER FORSTLICHE FORSCHUNG
BER. VOGELSCHUTZ	BERICHTE ZUM VOGELSCHUTZ
BERN. WALD	BERNER WALD
BERN. Z. GESCH. HEIM.KD.	BERNER ZEITSCHRIFT FÜR GESCHICHTE UND HEIMATKUNDE
BERN. ZTG.	BERNER ZEITUNG
BIBLIOGR. SCI. NAT. HELV.	BIBLIOGRAPHIA SCIENTIAE NATURALIS HELVETICA
BIBL. BOT.	BIBLIOTHECA BOTANICA
BIBL. LICHENOL.	BIBLIOTHECA LICHENOLOGICA
BIBL. MYCOL.	BIBLIOTHECA MYCOLOGICA
BILANZ	BILANZ
BILD WISS.	BILD DER WISSENSCHAFT
BILDMESS. LUFTBILDWES.	BILDMESSUNG UND LUFTBILDWESEN
BI-MON. RES. NOTES	BI-MONTHLY RESEARCH NOTES
BIOCHEM. SYST. ECOL.	BIOCHEMICAL SYSTEMATICS AND ECOLOGY
BIOCONTROL	BIOCONTROL
BIOCONTROL SCI. TECHNOL.	BIOCONTROL SCIENCE AND TECHNOLOGY
BIODIVERS. CONSERV.	BIODIVERSITY AND CONSERVATION
BIODIVERS. ECOL.	BIODIVERSITY & ECOLOGY
BIODIVERS. LETT.	BIODIVERSITY LETTERS
BIOGEOCHEMISTRY	BIOGEOCHEMISTRY
BIOGEOSCI. DISCUSS.	BIOGEOSCIENCES DISCUSSIONS
BIOGEOSCIENCES	BIOGEOSCIENCES
BIOL. GALLO-HELLENICA	BIOLOGIA GALLO-HELLENICA
BIOL. PLANT.	BIOLOGIA PLANTARUM
BIOL. CONSERV.	BIOLOGICAL CONSERVATION
BIOL. CONTROL	BIOLOGICAL CONTROL
BIOL. INVASIONS	BIOLOGICAL INVASIONS
BIOL. J. LINN. SOC.	BIOLOGICAL JOURNAL OF THE LINNEAN SOCIETY
BIOL. REV.	BIOLOGICAL REVIEWS
BIOL. TRACE ELEM. RES.	BIOLOGICAL TRACE ELEMENT RESEARCH
BIOL. RUNDSCH.	BIOLOGISCHE RUNDSCHAU
BIOL. ZENT.BL.	BIOLOGISCHES ZENTRALBLATT
BIOL. FERTIL. SOILS	BIOLOGY AND FERTILITY OF SOILS
BIOL. LETT.	BIOLOGY LETTERS
BIOMASS BIOENERGY	BIOMASS AND BIOENERGY
BIOM. J.	BIOMETRICAL JOURNAL
BIOMETRICS	BIOMETRICS
BIOM. INFORM. BIOL. MED.	BIOMETRIE UND INFORMATIK IN DER BIOLOGIE UND MEDIZIN
BIOMETRIKA	BIOMETRIKA
BIORESOUR. TECHNOL.	BIORESOURCE TECHNOLOGY
BIOSCIENCE	BIOSCIENCE
BIOTECHNOL. LETT.	BIOTECHNOLOGY LETTERS
BIOTROPICA	BIOTROPICA
BIRD STUD.	BIRD STUDY
BL. VER. PRO SIHLTAL	BLÄTTER DER VEREINIGUNG PRO SIHLTAL
BLAUE	BLAUE
BMC MOL. BIOL.	BMC MOLECULAR BIOLOGY
BNC PLANT BIOL.	BMC PLANT BIOLOGY
BMC PUBLIC HEALTH	BMC PUBLIC HEALTH
BODENKULTUR	BODENKULTUR
BOIS FOR. TROP.	BOIS ET FORÊTS DES TROPIQUES
BOLL. SOC. ITALIANA SCI. SUOLO	BOLLETINO DELLA SOCIETÀ ITALIANA DELLA SCIENZA DEL SUOLO
BOLL. SOC. TICIN. SCI. NAT.	BOLLETINO DELLA SOCIETÀ TICINESE DI SCIENZE NATURALI
BONN. GEOGR. ABH.	BONNER GEOGRAPHISCHE ABHANDLUNGEN
BONN. ZOOL. BEITR.	BONNER ZOOLOGISCHE BEITRÄGE
BOREAL ENVIRON. RES.	BOREAL ENVIRONMENT RESEARCH
BOREAS	BOREAS
BOT. ACTA	BOTANICA ACTA
BOT. HELV.	BOTANICA HELVETICA
BOT. GAZ.	BOTANICAL GAZETTE
BOT. J. LINN. SOC.	BOTANICAL JOURNAL OF THE LINNEAN SOCIETY
BOT. MAG. TOKYO	BOTANICAL MAGAZINE TOKYO
BOT. REV.	BOTANICAL REVIEW
BOTAN. ORIENT.	BOTANICA ORIENTALIS
BOT. JAHRB. SYST. PFLANZENGESCH. PFLANZENGEOGR.	BOTANISCHE JAHRBÜCHER FÜR SYSTEMATIK, PFLANZENGESCHICHTE UND PFLANZENGEOGRAPHIE
BOT. CENT.BL.	BOTANISCHES CENTRALBLATT
BOT. ZTG.	BOTANISCHE ZEITUNG
BOUND.-LAYER METEOROL.	BOUNDARY-LAYER METEOROLOGY
BRENESIA	BRENESIA
BRIEFE BOTAN. GART. ZÜRICH	BRIEFE AUS DEM BOTANISCHEN GARTEN ZÜRICH
BR. ARCHAEOL. REP., BR. SER.	BRITISH ARCHAEOLOGICAL REPORTS, BRITISH SERIES
BR. BIRDS	BRITISH BIRDS
BR. J. POLIT. SCI	BRITISH JOURNAL OF POLITICAL SCIENCE
BR. J. SPORTS MED.	BRITISH JOURNAL OF SPORTS MEDICINE
BR. LICHEN SOC. BULL.	BRITISH LICHEN SOCIETY BULLETIN
BR. PHYCOL. J.	BRITISH PHYCOLOGICAL JOURNAL
BRYOLOGIST	BRYOLOGIST
BULL. ANGEW. GEOL.	BULLETIN ANGEWANDTE GEOLOGIE
BULL. BODENKD. GES. SCHWEIZ	BULLETIN BODENKUNDLICHE GESELLSCHAFT DER SCHWEIZ
BULL. MURITHIENNE	BULLETIN DE LA MURITHIENNE
BULL. SOC. BOT. FR.	BULLETIN DE LA SOCIÉTÉ BOTANIQUE DE FRANCE
BULL. SOC. ENTOMOL. FR.	BULLETIN DE LA SOCIÉTÉ ENTOMOLOGIQUE DE FRANCE
BULL. SOC. ENTOMOL. SUISSE	BULLETIN DE LA SOCIÉTÉ ENTOMOLOGIQUE SUISSE
BULL. SOC. FR. PHOTOGRAMM. TÉLÉDÉTECT.	BULLETIN DE LA SOCIÉTÉ FRANÇAISE DE PHOTOGRAMMÉTRIE ET TÉLÉDÉTECTION
BULL. SOC. FRIBG. SCI. NAT.	BULLETIN DE LA SOCIÉTÉ FRIBOURGEOISE DES SCIENCES NATURELLES
BULL. SOC. GÉOL. FR.	BULLETIN DE LA SOCIÉTÉ GÉOLOGIQUE DE FRANCE
BULL. SOC. MYCOL. FR.	BULLETIN DE LA SOCIÉTÉ MYCOLOGIQUE DE FRANCE
BULL. SOC. NEUCHÂTEL. SCI. NAT.	BULLETIN DE LA SOCIÉTÉ NEUCHÂTELOISE DES SCIENCES NATURELLES
BULL. SOC. R. BELG. ENTOMOL.	BULLETIN DE LA SOCIÉTÉ ROYAL BELGE DENTOMOLOGIE
BULL. SOC. R. SCI. LIÈGE	BULLETIN DE LA SOCIÉTÉ ROYALE DES SCIENCES DE LIÉGE
BULL. SOC. R. FOR. BELG.	BULLETIN DE LA SOCIÉTÉ ROYALE FORESTIÈRE DE BELGIQUE
BULL. SOC. VAUD. SCI. NAT.	BULLETIN DE LA SOCIÉTÉ VAUDOISE DES SCIENCES NATURELLES
BULL. ASSOC. DÉF. INTÉRÊTS JURA	BULLETIN DE L'ASSOCIATION POUR LA DÉFENSE DES INTÉRÊTS DU JURA
BULL. RECH. AGRON. GEMBLOUX	BULLETIN DES RECHERCHES AGRONOMIQUES DE GEMBLOUX
BULL. VULG. FOR.	BULLETIN DE VULGARISATION FORESTIÈRE
BULL. INF. OFF. NATL. FOR.	BULLETIN D'INFORMATION OFFICE NATIONAL DES FORÊTS
BULL. INF. TECH.	BULLETIN D'INFORMATIONS TECHNIQUES
BULL. CERCLE VAUDOIS BOT.	BULLETIN DU CERCLE VAUDOIS DE BOTANIQUE
BULL. E-GEO.CH	BULLETIN E-GEO.CH
BULL. FOR. COMM.	BULLETIN FORESTRY COMMISSION
BULL. GEOL. SOC. AM.	BULLETIN GEOLOGICAL SOCIETY OF AMERICA
BULL. GEOL. SURV. CAN.	BULLETIN GEOLOGICAL SURVEY OF CANADA
BULL. MENS. SOC. LINN. LYON	BULLETIN MENSUEL DE LA SOCIÉTÉ LINNÉENNE DE LYON
BULL. MYCOL. BOT.	BULLETIN MYCOLOGIQUE ET BOTANIQUE
BULL. ANIM. BEHAV.	BULLETIN OF ANIMAL BEHAVIOUR
BULL. ENG. GEOL. ENVIRON.	BULLETIN OF ENGINEERING GEOLOGY AND THE ENVIRONMENT
BULL. ENVIRON. CONTAM. TOXICOL.	BULLETIN OF ENVIRONMENTAL CONTAMINATION AND TOXICOLOGY
BULL. INDONES. ECON. STUD.	BULLETIN OF INDONESIAN ECONOMIC STUDIES
BULL. AM. METEOROL. SOC.	BULLETIN OF THE AMERICAN METEOROLOGICAL SOCIETY
BULL. AM. PHYS. SOC.	BULLETIN OF THE AMERICAN PHYSICAL SOCIETY
BULL. BIOGEOGR. SOC. JPN.	BULLETIN OF THE BIOGEOGRAPHICAL SOCIETY OF JAPAN
BULL. BR. MUS. NAT. HIST., BOT.	BULLETIN OF THE BRITISH MUSEUM OF NATURAL HISTORY, BOTANY
BULL. BR. MYCOL. SOC.	BULLETIN OF THE BRITISH MYCOLOGICAL SOCIETY
BULL. BR. ORNITHOL. CLUB	BULLETIN OF THE BRITISH ORNITHOLOGISTS CLUB
BULL. CALIF. AGRIC. EXP. STN.	BULLETIN OF THE CALIFORNIA AGRICULTURAL EXPERIMENT STATION
BULL. GEOBOT. INST. ETH	BULLETIN OF THE GEOBOTANICAL INSTITUTE ETH
BULL. GEOL. SOC. FINL.	BULLETIN OF THE GEOLOGICAL SOCIETY OF FINLAND
BULL. INT. ASSOC. SCI. HYDROL.	BULLETIN OF THE INTERNATIONAL ASSOCIATION OF SCIENTIFIC HYDROLOGY
BULL. VOLCANOL.	BULLETIN OF VOLCANOLOGY
BULL. PEABODY MUS. NAT. HIST., YALE UNIV.	BULLETIN PEABODY MUSEUM OF NATURAL HISTORY, YALE UNIVERSITY
BULL. ROMAND ENTOMOL.	BULLETIN ROMAND D'ENTOMOLOGIE
BULL. SUISSE MYCOL.	BULLETIN SUISSE DE MYCOLOGIE
BULL. TECH. SUISSE ROMANDE	BULLETIN TECHNIQUE DE LA SUISSE ROMANDE
BÜNDNER JÄGER	BÜNDNER JÄGER
BÜNDNER MON.BL.	BÜNDNER MONATSBLATT
BÜNDNERWALD	BÜNDNERWALD
BÜNDNERWALD, BEIH.	BÜNDNERWALD, BEIHEFT
BÜRG. STAAT	BÜRGER IM STAAT
CAH. CENT. TECH. BOIS	CAHIER DU CENTRE TECHNIQUE DU BOIS
CALIF. AGRIC.	CALIFORNIA AGRICULTURE
CAN. ENTOMOL.	CANADIAN ENTOMOLOGIST
CAN. GEOGR.	CANADIAN GEOGRAPHER
CAN. GEOTECH. J.	CANADIAN GEOTECHNICAL JOURNAL
CAN. J. BOT.	CANADIAN JOURNAL OF BOTANY
CAN. J. EARTH SCI.	CANADIAN JOURNAL OF EARTH SCIENCES
CAN. J. FOR. RES.	CANADIAN JOURNAL OF FOREST RESEARCH
CAN. J. MICROBIOL.	CANADIAN JOURNAL OF MICROBIOLOGY
CAN. J. PLANT PATHOL.	CANADIAN JOURNAL OF PLANT PATHOLOGY
CAN. J. PLANT SCI.	CANADIAN JOURNAL OF PLANT SCIENCE
CAN. J. REMOTE SENS.	CANADIAN JOURNAL OF REMOTE SENSING
CAN. J. SOIL SCI.	CANADIAN JOURNAL OF SOIL SCIENCE
CAN. J. ZOOL.	CANADIAN JOURNAL OF ZOOLOGY
CANCER RES.	CANCER RESEARCH
CANDOLLEA	CANDOLLEA
CARBON MANAG.	CARBON MANAGEMENT
CARINTHIA II	CARINTHIA II
CARPATHIAN J. EARTH ENVIRON. SCI.	CARPATHIAN JOURNAL OF EARTH AND ENVIRONMENTAL SCIENCES
CARTOGR. GEOGR. INF. SCI.	CARTOGRAPHY AND GEOGRAPHIC INFORMATION SCIENCE
CATENA	CATENA
CELL BIOCHEM. BIOPHYS.	CELL BIOCHEMISTRY AND BIOPHYSICS
CELL. MOL. LIFE SCI.	CELLULAR AND MOLECULAR LIFE SCIENCE
CELL. MICROBIOL.	CELLULAR MICROBIOLOGY
CEM. CONCR. RES.	CEMENT AND CONCRETE RESEARCH
CENT.BL. GESAMTE FORSTWES.	CENTRALBLATT FÜR DAS GESAMTE FORSTWESEN
CENT. EUR. FOR.	CENTRAL EUROPEAN FORESTS
CEYLON FOR.	CEYLON FORESTER
CHEM. GEOL.	CHEMICAL GEOLOGY
CHEMOSPHERE	CHEMOSPHERE
CHIMIA	CHIMIA
CH-WILDINFO	CH-WILDINFO
CITIES ENVIRON.	CITIES AND THE ENVIRONMENT
CLAY MINER.	CLAY MINERALS
CLAYS CLAY MINER.	CLAYS AND CLAY MINERALS
CLIM. DYN.	CLIMATE DYNAMICS
CLIM. PAST	CLIMATE OF THE PAST
CLIM. POLICY	CLIMATE POLICY
CLIM. RES.	CLIMATE RESEARCH
CLIM. RISK MANAG.	CLIMATE RISK MANAGEMENT
CLIM. CHANG.	CLIMATIC CHANGE
CLIN. INFECT. DIS.	CLINICAL INFECTIOUS DISEASES
COENOSES	COENOSES
COGN. AFFECT. BEHAV. NEUROSCI.	COGNITIVE AFFECTIVE AND BEHAVIORAL NEUROSCIENCE
COLD REG. SCI. TECHNOL.	COLD REGIONS SCIENCE AND TECHNOLOGY
COLLOQ. PHYTOSOCIOL.	COLLOQUES PHYTOSOCIOLOGIQUES
COLON. PLANT ANIM. PROD.	COLONIAL PLANT AND ANIMAL PRODUCTS
COLON. WATERBIRDS	COLONIAL WATERBIRDS
COMMONW. FOR. REV.	COMMONWEALTH FORESTRY REVIEW
COMMUN. INST. FOR. FENN.	COMMUNICATIONES INSTITUTI FORESTALIS FENNIAE
COMMUN. SOIL SCI. PLANT ANAL.	COMMUNICATIONS IN SOIL SCIENCE AND PLANT ANALYSIS
COMMUN. STAT. THEORY METHODS	COMMUNICATIONS IN STATISTICS - THEORY AND METHODS
COMMUNIST POST-COMMUNIST STUD.	COMMUNIST AND POST-COMMUNIST STUDIES
COMMUNITY ECOL.	COMMUNITY ECOLOGY
COMP. BIOCHEM. PHYSIOL.	COMPARATIVE BIOCHEMISTRY AND PHYSIOLOGY
COMPTES RENDUS SÉANCE ACAD. AGRIC. FR.	COMPTES RENDUS DES SÉANCES DE L'ACADÉMIE D'AGRICULTURE DE FRANCE
COMPTES RENDUS HEBD. SÉANCES ACAD. SCI. PARIS	COMPTES RENDUS HEBDOMADAIRES DES SÉANCES DE L'ACADÉMIE DES SCIENCES, PARIS
COMPTES RENDUS PHYS.	COMPTES RENDUS PHYSIQUE
COMPUT. GEOSCI.	COMPUTATIONAL GEOSCIENCES
COMPUT. STAT. DATA ANAL.	COMPUTATIONAL STATISTICS AND DATA ANALYSIS
COMPUT. APPL. BIOSCI.	COMPUTER APPLICATIONS IN THE BIOSCIENCES
COMPUT. GRAPH. FORUM	COMPUTER GRAPHICS FORUM
COMPUT. PHYS. COMMUN.	COMPUTER PHYSICS COMMUNICATIONS
COMPUT. ELECTRON. AGRIC.	COMPUTERS AND ELECTRONICS IN AGRICULTURE
COMPUT. GEOTECH.	COMPUTERS AND GEOTECHNICS
COMPUT. ENVIRON. URBAN SYST.	COMPUTERS ENVIRONMENT AND URBAN SYSTEMS
COMPUT. SCI. ENG.	COMPUTING IN SCIENCE AND ENGINEERING
CONDOR	CONDOR
CONSERV. BIOL.	CONSERVATION BIOLOGY
CONSERV. GENET.	CONSERVATION GENETICS
CONSERV. GENET. RESOUR.	CONSERVATION GENETICS RESOURCES
CONSERV. LETT.	CONSERVATION LETTERS
CONTIN. MECH. THERMODYN.	CONTINUUM MECHANICS AND THERMODYNAMICS
CONTRIB. CENT. RES. INST. AGRIC. BOGOR	CONTRIBUTIONS FROM THE CENTRAL RESEARCH INSTITUTE FOR AGRICULTURE BOGOR
CONTRIB. U. S. NATL. HERB.	CONTRIBUTIONS FROM THE UNITED STATES NATIONAL HERBARIUM
COORD. CHEM. REV.	COORDINATION CHEMISTRY REVIEWS
CORAX	CORAX
CORNELL PLANT.	CORNELL PLANTATIONS
COURR. ENVIRON. INRA	COURRIER DE L'ENVIRONNEMENT DE L'INRA
COURR. EXPLOIT. SCIEUR	COURRIER DE L'EXPLOITANT ET DU SCIEUR
CRATSCHLA	CRATSCHLA
CROAT. J. FOR. ENG.	CROATIAN JOURNAL OF FOREST ENGINEERING
CRYOSPHERE	CRYOSPHERE
CRYPTOGAM. BOT.	CRYPTOGAMIC BOTANY
CURR. ISSUES TOUR.	CURRENT ISSUES IN TOURISM
CURR. OPIN. ENVIRON. SUSTAINABILITY	CURRENT OPINION IN ENVIRONMENTAL SUSTAINABILITY
CURR. OPIN. PLANT BIOL.	CURRENT OPINION IN PLANT BIOLOGY
CURR. SCI.	CURRENT SCIENCE
DAVOS. REV.	DAVOSER REVUE
DEEP-SEA RES. II	DEEP-SEA RESEARCH II
DENDROCHRONOLOGIA	DENDROCHRONOLOGIA
DENDRONATURA	DENDRONATURA
DENKSCHR. SCHWEIZ. NAT.FORSCH. GES.	DENKSCHRIFTEN DER SCHWEIZERISCHEN NATURFORSCHENDEN GESELLSCHAFT
DTSCH. BAUMSCH.	DEUTSCHE BAUMSCHULE
DTSCH. GEWÄSSERKDL. MITT.	DEUTSCHE GEWÄSSERKUNDLICHE MITTEILUNGEN
DTSCH. HYDROGR. Z.	DEUTSCHE HYDROGRAPHISCHE ZEITSCHRIFT
DTSCH. JÄGER-ZTG.	DEUTSCHE JÄGER-ZEITUNG
DEV. CHANG.	DEVELOPMENT AND CHANGE
DISS. BOT.	DISSERTATIONES BOTANICAE
DIVERSITY	DIVERSITY
DIVERS. DISTRIB.	DIVERSITY AND DISTRIBUTIONS
DOC. FAUN. HELV.	DOCUMENTA FAUNISTICA HELVETIAE
DOC. MYCOL.	DOCUMENTS MYCOLOGIQUES
DOC. PHYTOSOCIOL., NOUV. SÉR.	DOCUMENTS PHYTOSOCIOLOGIQUES, NOUVELLE SÉRIE
DOK. BODENKD. GES. SCHWEIZ	DOKUMENT BODENKUNDLICHE GESELLSCHAFT DER SCHWEIZ
DOK. INF. SCHWEIZ. ORTS- REG.- LANDESPLAN., DISP	DOKUMENTE UND INFORMATIONEN ZUR SCHWEIZERISCHEN ORTS-, REGIONAL- UND LANDESPLANUNG, DISP
DOMEST. ANIM. ENDOCRINOL.	DOMESTIC ANIMAL ENDOCRINOLOGY
DROSERA	DROSERA
EARTH PLANET. SCI. LETT.	EARTH AND PLANETARY SCIENCE LETTERS
EARTH INTERACT.	EARTH INTERACTIONS
EARTH-SCI. REV.	EARTH-SCIENCE REVIEWS
EARTH SURF. DYN.	EARTH SURFACE DYNAMICS
EARTH SURF. PROCESS. LANDF.	EARTH SURFACE PROCESSES AND LANDFORMS
ECLOGAE GEOL. HELV.	ECLOGAE GEOLOGICAE HELVETIAE
ECOGRAPHY	ECOGRAPHY
ECOHYDROL. HYDROBIOL.	ECOHYDROLOGY AND HYDROBIOLOGY
ECOHYDROLOGY	ECOHYDROLOGY
ECOL. MEDITERR.	ECOLOGIA MEDITERRANEA
ECOL. APPL.	ECOLOGICAL APPLICATIONS
ECOL. COMPLEXITY	ECOLOGICAL COMPLEXITY
ECOL. ECON.	ECOLOGICAL ECONOMICS
ECOL. ENG.	ECOLOGICAL ENGINEERING
ECOL. ENTOMOL.	ECOLOGICAL ENTOMOLOGY
ECOL. INDIC.	ECOLOGICAL INDICATORS
ECOL. MANAGE. RESTOR.	ECOLOGICAL MANAGEMENT AND RESTORATION
ECOL. MODEL.	ECOLOGICAL MODELLING
ECOL. MONOGR.	ECOLOGICAL MONOGRAPHS
ECOL. RES.	ECOLOGICAL RESEARCH
ECOL. STUD.	ECOLOGICAL STUDIES
ECOL. ENVIRON. SCI.	ECOLOGY AND ENVIRONMENTAL SCIENCE
ECOL. EVOL.	ECOLOGY AND EVOLUTION
ECOL. SOC.	ECOLOGY AND SOCIETY
ECOL. LETT.	ECOLOGY LETTERS
ECOLOGY	ECOLOGY
ECON. BOT.	ECONOMIC BOTANY
ECON. GEOGR.	ECONOMIC GEOGRAPHY
ECON. AGRIC.	ECONOMIE AGRICOLE
ECOSPHERE	ECOSPHERE
ECOSYST. SERV.	ECOSYSTEM SERVICES
ECOSYSTEMS	ECOSYSTEMS
ECOTOXICOL. ENVIRON. SAF.	ECOTOXICOLOGY AND ENVIRONMENTAL SAFETY
EISZEITALT. GGW.	EISZEITALTER UND GEGENWART
EKOLOGIA (CSSR)	EKOLOGIA (CSSR)
ELECTRON MICROSC.	ELECTRON MICROSCOPY
ENDANGER. SPECIES RES.	ENDANGERED SPECIES RESEARCH
ENERGY BUILD.	ENERGY AND BUILDINGS
ENERGY POLICY	ENERGY POLICY
ENG. GEOL.	ENGINEERING GEOLOGY
ENG. STRUCT.	ENGINEERING STRUCTURES
ENTOMOFAUNA	ENTOMOFAUNA
ENTOMO HELV.	ENTOMO HELVETICA
ENTOMOL. EXP. APPL.	ENTOMOLOGIA EXPERIMENTALIS ET APPLICATA
ENTOMOL. GEN.	ENTOMOLOGIA GENERALIS
ENTOMOL. BER. LUZERN	ENTOMOLOGISCHE BERICHTE LUZERN
ENTOMOL. NACHR. BERL.	ENTOMOLOGISCHE NACHRICHTEN BERLIN
ENTOMOL. Z.	ENTOMOLOGISCHE ZEITSCHRIFT
ENTREP. REG. DEV.	ENTREPRENEURSHIP AND REGIONAL DEVELOPMENT
ENVIRON. ECOL. STAT.	ENVIRONMENTAL AND ECOLOGICAL STATISTICS
ENVIRON. EXP. BOT.	ENVIRONMENTAL AND EXPERIMENTAL BOTANY
ENVIRON. RESOUR. ECON.	ENVIRONMENTAL AND RESOURCE ECONOMICS
ENVIRON. CONSERV.	ENVIRONMENTAL CONSERVATION
ENVIRON. ENTOMOL.	ENVIRONMENTAL ENTOMOLOGY
ENVIRON. ETHICS	ENVIRONMENTAL ETHICS
ENVIRON. GEOCHEM. HEALTH	ENVIRONMENTAL GEOCHEMISTRY AND HEALTH
ENVIRON. GEOL. WATER SCI.	ENVIRONMENTAL GEOLOGY AND WATER SCIENCES
ENVIRON. GEOL.	ENVIRONMENTAL GEOLOGY
ENVIRON. HEALTH PERSPECT.	ENVIRONMENTAL HEALTH PERSPECTIVES
ENVIRON. HIST. NEWSL.	ENVIRONMENTAL HISTORY NEWSLETTER
ENVIRON. IMPACT ASSESS. REV.	ENVIRONMENTAL IMPACT ASSESSMENT REVIEW
ENVIRON. MANAGE.	ENVIRONMENTAL MANAGEMENT
ENVIRON. MICROBIOL.	ENVIRONMENTAL MICROBIOLOGY
ENVIRON. MICROBIOL. REP.	ENVIRONMENTAL MICROBIOLOGY REPORTS
ENVIRON. MODEL. ASSESS.	ENVIRONMENTAL MODELING AND ASSESSMENT
ENVIRON. MODEL. SOFTW.	ENVIRONMENTAL MODELLING AND SOFTWARE[R]
ENVIRON. MONIT. ASSESS.	ENVIRONMENTAL MONITORING AND ASSESSMENT
ENVIRON. POLICY GOVERNANCE	ENVIRONMENTAL POLICY AND GOVERNANCE
ENVIRON. POLICY LAW	ENVIRONMENTAL POLICY AND LAW
ENVIRON. POLLUT.	ENVIRONMENTAL POLLUTION
ENVIRON. RES. LETT.	ENVIRONMENTAL RESEARCH LETTERS
ENVIRON. REV.	ENVIRONMENTAL REVIEW
ENVIRON. SCI. POLICY	ENVIRONMENTAL SCIENCE AND POLICY
ENVIRON. SCI. POLLUT. RES.	ENVIRONMENTAL SCIENCE AND POLLUTION RESEARCH
ENVIRON. SCI. TECHNOL.	ENVIRONMENTAL SCIENCE AND TECHNOLOGY
ENVIRON. TOXICOL. CHEM.	ENVIRONMENTAL TOXICOLOGY AND CHEMISTRY
ENVIRON. VALUES	ENVIRONMENTAL VALUES
ENVIRON. BEHAV.	ENVIRONMENT AND BEHAVIOR
ENVIRON. DEV. ECON.	ENVIRONMENT AND DEVELOPMENT ECONOMICS
ENVIRON. HIST.	ENVIRONMENT AND HISTORY
ENVIRON. PLAN. B - PLAN. DES.	ENVIRONMENT AND PLANNING B - PLANNING AND DESIGN
ENVIRON. PLAN. C GOV. PRACT.	ENVIRONMENT AND PLANNING C: GOVERNMENT AND PRACTICE
ENVIRON. INT.	ENVIRONMENT INTERNATIONAL
ENVIRONMETRICS	ENVIRONMETRICS
ENZYM. MICROB. TECHNOL.	ENZYME AND MICROBIAL TECHNOLOGY
EOS, TRANS. AM. GEOPHYS. UNION	EOS, TRANSACTIONS, AMERICAN GEOPHYSICAL UNION
EPL	EPL
ERDKUNDE	ERDKUNDE
ERDKUND. WISSEN	ERDKUNDLICHES WISSEN
ERGEB. WISS. UNTERS. SCHWEIZ. NATL.PARK	ERGEBNISSE DER WISSENSCHAFTLICHEN UNTERSUCHUNGEN IM SCHWEIZERISCHEN NATIONALPARK
ESPER. RIC.	ESPERIENZE E RICERCHE
ES +T	ES + T
ETFRN NEWSLETTER	ETFRN (EUROPEAN TROPICAL FOREST RESEARCH NETWORK) NEWSLETTER
ETHIK GES.	ETHIK UND GESELLSCHAFT
ETHOLOGY	ETHOLOGY
ETUD. GEST. SOLS	ETUDE ET GESTION DES SOLS
EURASIAN SOIL SCI.	EURASIAN SOIL SCIENCE
EUR. J. CELL BIOL.	EUROPEAN JOURNAL OF CELL BIOLOGY
EUR. J. ENTOMOL.	EUROPEAN JOURNAL OF ENTOMOLOGY
EUR. J. FOR. PATHOL.	EUROPEAN JOURNAL OF FOREST PATHOLOGY
EUR. J. FOR. RES.	EUROPEAN JOURNAL OF FOREST RESEARCH
EUR. J. PLANT PATHOL.	EUROPEAN JOURNAL OF PLANT PATHOLOGY
EUR. J. SOC. THEORY	EUROPEAN JOURNAL OF SOCIAL THEORY
EUROP. J. SOIL BIOL.	EUROPEAN JOURNAL OF SOIL BIOLOGY
EUR. J. SOIL SCI.	EUROPEAN JOURNAL OF SOIL SCIENCE
EUR. J. WILDL. RES.	EUROPEAN JOURNAL OF WILDLIFE RESEARCH
EUR. MOL. BIOL. ORGAN. J.	EUROPEAN MOLECULAR BIOLOGY ORGANIZATION JOURNAL
EUR. PLAN. STUD.	EUROPEAN PLANNING STUDIES
EVOL. BIOL.	EVOLUTIONARY BIOLOGY
EVOL. ECOL.	EVOLUTIONARY ECOLOGY
EVOL. ECOL. RES.	EVOLUTIONARY ECOLOGY RESEARCH
EVOLUTION	EVOLUTION
EXP. APPL. ACAROL.	EXPERIMENTAL AND APPLIED ACAROLOGY
EXP. BOT.	EXPERIMENTAL BOTANY
EXP. MYCOL.	EXPERIMENTAL MYCOLOGY
EXTREMOPHILES	EXTREMOPHILES
FAN AGENDA	FACHLEUTE NATURGEFAHREN SCHWEIZ AGENDA
FALKE	FALKE
FAO FOR. DEV. PAP.	FAO FORESTRY DEVELOPMENT PAPER
FEDDES REPERT.	FEDDES REPERTORIUM
FED. EUR. BIOCHEM. SOC. LETT.	FEDERATION OF EUROPEAN BIOCHEMICAL SOCIETIES LETTERS
FEEM - NOTA LAV.	FEEM - NOTA DI LAVORO
FELSBAU MAG.	FELSBAU MAGAZIN
FEMS MICROBIOL. ECOL.	FEMS MICROBIOLOGY ECOLOGY
FERNERKUND. PHOTOGRAMM.	FERNERKUNDUNG UND PHOTOGRAMMETRIE
FERTIL. RES.	FERTILIZER RESEARCH
FIELD STUD.	FIELD STUDIES
FIRE ECOL.	FIRE ECOLOGY
FIS-BULL.	FIS-BULLETIN
FISH. AQUAT. SCI.	FISHERIES AND AQUATIC SCIENCES
FLEDERMAUS- ANZ.	FLEDERMAUS-ANZEIGER
FLORA	FLORA
FLA. SCI.	FLORIDA SCIENTIST
FLORIST. RD.BR.	FLORISTISCHE RUNDBRIEFE
FOLIA CRYPTOGAM. EST.	FOLIA CRYPTOGAMICA ESTONICA
FOLIA FOR. POL.	FOLIA FORESTALIA POLONICA
FOLIA GEOBOT. PHYTOTAXON.	FOLIA GEOBOTANICA ET PHYTOTAXONOMICA
FOLIA ZOOL.	FOLIA ZOOLOGICA
FOOD NUTR. BULL.	FOOD AND NUTRITION BULLETIN
FOOD QUAL. PREFER.	FOOD QUALITY AND PREFERENCE
FOR. LANDSC. RES.	FOREST AND LANDSCAPE RESEARCH
FORESTAVIVA	FORESTAVIVA
FOR. ECOL. MANAGE.	FOREST ECOLOGY AND MANAGEMENT
FOR. ECOSYST.	FOREST ECOSYSTEMS
FOR. GENET.	FOREST GENETICS
FOR. IND.	FOREST INDUSTRIES
FOR. INSECT DIS. LEAFL.	FOREST INSECT & DISEASE LEAFLET
FOR. PATHOL.	FOREST PATHOLOGY
FOR. POLICY ECON.	FOREST POLICY AND ECONOMICS
FOR. PROD. J.	FOREST PRODUCTS JOURNAL
FOR. RES. INF. PAP.	FOREST RESEARCH INFORMATION PAPER
FOR. ABSTR.	FORESTRY ABSTRACTS
FOR. CHRON.	FORESTRY CHRONICLE
FORESTRY	FORESTRY
FOR. TECH. REP.	FORESTRY TECHNICAL REPORT
FOR. SCI.	FOREST SCIENCE
FOR. SNOW LANDSC. RES.	FOREST SNOW AND LANDSCAPE RESEARCH
FORESTS	FORESTS
FORÊT	FORÊT
FOR. MÉDITERR.	FORÊT MÉDITERRANÉENNE
FOR. FR.	FORÊTS DE FRANCE
FOR. FR. ACTION FOR.	FORÊTS DE FRANCE ET ACTION FORESTIÈRE
FORÊT SUISSE	FORÊT SUISSE
FORSCH. KOMPLEMENTÄRMED.	FORSCHENDE KOMPLEMENTÄRMEDIZIN
FORSCH.BER. FORSTL. FORSCH.ANST. MÜNCH.	FORSCHUNGSBERICHT FORSTLICHE FORSCHUNGSANSTALT MÜNCHEN
FORSTARCHIV	FORSTARCHIV
FORSTL. FORSCH.BER. MÜNCH.	FORSTLICHE FORSCHUNGSBERICHTE MÜNCHEN
FORSTL. RUNDSCH.	FORSTLICHE RUNDSCHAU
FORSTL. UMSCH.	FORSTLICHE UMSCHAU
FORSTL.-NAT.WISS. Z.	FORSTLICH-NATURWISSENSCHAFTLICHE ZEITSCHRIFT
FORSTL. FORSØGSVAES. DAN.	FORSTLIGE FORSØGSVAESEN I DANMARK
FORSTSCHUTZ BULL.	FORSTSCHUTZ BULLETIN
FORSTTECH. INF.	FORSTTECHNISCHE INFORMATIONEN
FORST HOLZ	FORST UND HOLZ
FORST- HOLZWIRT	FORST- UND HOLZWIRT
FORSTWISS. CENT.BL.	FORSTWISSENSCHAFTLICHES CENTRALBLATT
FORSTZTG.	FORSTZEITUNG
FORUM HYDROL. WASSERBEWIRTSCH.	FORUM FÜR HYDROLOGIE UND WASSERBEWIRTSCHAFTUNG
FRAGM. FLOR. GEOBOT.	FRAGMENTA FLORISTICA ET GEOBOTANICA
FREIBG. BODENKD. ABH.	FREIBURGER BODENKUNDLICHE ABHANDLUNGEN
FREIBG. GEOGR. HEFTE	FREIBURGER GEOGRAPHISCHE HEFTE
FREIBG. SCHR. HYDROL.	FREIBURGER SCHRIFTEN ZUR HYDROLOGIE
FRESHWATER BIOL.	FRESHWATER BIOLOGY
FRONT. ECOL. EVOL.	FRONTIERS IN ECOLOGY AND EVOLUTION
FRONT. ECOL. ENVIRON.	FRONTIERS IN ECOLOGY AND THE ENVIRONMENT
FRONT. MICROBIOL.	FRONTIERS IN MICROBIOLOGY
FRONT. PLANT SCI.	FRONTIERS IN PLANT SCIENCE
FRONT. BIOGEOGR.	FRONTIERS OF BIOGEOGRAPHY
FRONT. EARTH SCI.	FRONTIERS OF EARTH SCIENCE
FRUTTICOLTURA	FRUTTICOLTURA
FUNCT. ECOL.	FUNCTIONAL ECOLOGY
FUNCT. PLANT BIOL.	FUNCTIONAL PLANT BIOLOGY
FUNGAL BIOL.	FUNGAL BIOLOGY
FUNGAL CONSERV.	FUNGAL CONSERVATION
FUNGAL DIVERS.	FUNGAL DIVERSITY
FUNGAL ECOL.	FUNGAL ECOLOGY
FUNGAL GENET. BIOL.	FUNGAL GENETICS AND BIOLOGY
FUTURES	FUTURES
GAIA	GAIA
GARTENAMT	GARTENAMT
GARTENBAU	GARTENBAU
GAS WASSER ABWASSER	GAS, WASSER, ABWASSER
GEFIED. WELT	GEFIEDERTE WELT
GEGENBAURS MORPHOL. JAHRB.	GEGENBAURS MORPHOLOGISCHES JAHRBUCH
GEN. COMP. ENDOCRINOL.	GENERAL AND COMPARATIVE ENDOCRINOLOGY
GEN. TECH. REP. USDA FOR. SERV.	GENERAL TECHNICAL REPORT USDA FOREST SERVICE
GENES GENET. SYST.	GENES AND GENETIC SYSTEMS
GENET. RES.	GENETICAL RESEARCH
GENET. MOL. RES.	GENETICS AND MOLECULAR RESEARCH
GENETICS	GENETICS
GENOME BIOL. EVOL.	GENOME BIOLOGY AND EVOLUTION
GENOME RES.	GENOME RESEARCH
GEOAGENDA	GEOAGENDA
GEOBIOL.	GEOBIOLOGY
GEOBOT. HELV.	GEOBOTANICA HELVETICA
GEOBOT. SEL.	GEOBOTANICA SELECTA
GEOCHEM. GEOPHYS. GEOSYST.	GEOCHEMISTRY GEOPHYSICS GEOSYSTEMS
GEOCHIM. COSMOCHIM. ACTA	GEOCHIMICA ET COSMOCHIMICA ACTA
GEOCHRONOMETRIA	GEOCHRONOMETRIA
GEODERMA	GEODERMA
GEODIN. ACTA	GEODINAMICA ACTA
GEOFIS. PURA APPL.	GEOFISICA PURA E APPLICATA
GEOFORUM	GEOFORUM
GEOGR. FIS. DINAM. QUAT.	GEOGRAFIA FISICA E DINAMICA QUATERNARIA
GEOGR. ANN.	GEOGRAFISKA ANNALER
GEOGR. ANN. SER. A-PHYS. GEOGR.	GEOGRAFISKA ANNALER: SERIES A, PHYSICAL GEOGRAPHY
GEOGR. POL.	GEOGRAPHIA POLONICA
GEOGR. BERN.	GEOGRAPHICA BERNENSIA
GEOGR. HELV.	GEOGRAPHICA HELVETICA
GEOGR. J.	GEOGRAPHICAL JOURNAL
GEOGR. REV.	GEOGRAPHICAL REVIEW
GÉOGR. PHYS. QUAT.	GÉOGRAPHIE PHYSIQUE ET QUATERNAIRE
GEOGR. RUNDSCH.	GEOGRAPHISCHE RUNDSCHAU
GEOGR. COMPASS	GEOGRAPHY COMPASS
GEOJOURNAL	GEOJOURNAL
GEOLOGY	GEOLOGY
GEOMATIK SCHWEIZ	GEOMATIK SCHWEIZ
GEOMICROBIOL. J.	GEOMICROBIOLOGY JOURNAL
GEOMORPHOLOGY	GEOMORPHOLOGY
GEO-ÖKO	GEO-ÖKO
GEO PANORAMA	GEOPANORAMA
GEOPHYS. J. INT.	GEOPHYSICAL JOURNAL INTERNATIONAL
GEOPHYS. PROSPECT.	GEOPHYSICAL PROSPECTING
GEOPHYS. RES. ABSTR.	GEOPHYSICAL RESEARCH ABSTRACTS
GEOPHYS. RES. LETT.	GEOPHYSICAL RESEARCH LETTERS
GEOSCI. INSTRUM. METHODS DATA SYS.	GEOSCIENTIFIC INSTRUMENTATION, METHODS AND DATA SYSTEMS
GEOSCI. MODEL DEV. DISCUSS.	GEOSCIENTIFIC MODEL DEVELOPMENT DISCUSSIONS
GEOSCI. MODEL DEV.	GEOSCIENTIFIC MODEL DEVELOPMENT
GEOTECH. GEOL. ENG.	GEOTECHNICAL AND GEOLOGICAL ENGINEERING
GEOTEXT. GEOMEMBR.	GEOTEXTILES AND GEOMEMBRANES
GESETZGEB. BUNDES KANTONE	GESETZGEBUNG DES BUNDES UND DER KANTONE
GESUNDE PFLANZEN	GESUNDE PFLANZEN
GIESS. GEOGR. SCHR.	GIESSENER GEOGRAPHISCHE SCHRIFTEN
G. POP.	GIORNALE DEL POPOLO
GIT, FACHZ. LAB.	GIT, FACHZEITSCHRIFT FÜR DAS LABORATORIUM
GLOB. PLANET. CHANG.	GLOBAL AND PLANETARY CHANGE
GLOB. BIOGEOCHEM. CYCLES	GLOBAL BIOGEOCHEMICAL CYCLES
GLOB. CHANG. BIOL.	GLOBAL CHANGE BIOLOGY
GLOB. ECOL. BIOGEOGR. LETT.	GLOBAL ECOLOGY AND BIOGEOGRAPHY LETTERS
GLOB. ECOL. BIOGEOGR.	GLOBAL ECOLOGY BIOGEOGRAPHY
GLOB. ENVIRON. CHANG.	GLOBAL ENVIRONMENTAL CHANGE
G' PLUS	G'PLUS
GRANULAR MATTER	GRANULAR MATTER
GRAPH. SCR.	GRAPHIS SCRIPTA
GRASS FORAGE SCI.	GRASS AND FORAGE SCIENCE
GRASSL. SCI. EUR.	GRASSLAND SCIENCE IN EUROPE
GT. BASIN NAT.	GREAT BASIN NATURALIST
GT. LAKES ENTOMOL.	GREAT LAKES ENTOMOLOGIST
GREDLERIANA	GREDLERIANA
GROUND WATER	GROUND WATER
GRÜNE	GRÜNE
GRÜNZEIT	GRÜNZEIT
HANDB. VEG. SCI.	HANDBOOK OF VEGETATION SCIENCE
HELV. ARCHAEOL.	HELVETIA ARCHAEOLOGICA
HEREDITY	HEREDITY
HERPETOL. BULL.	HERPETOLGICAL BULLETIN
HERPETOL. CONSERV. BIOL.	HERPETOLOGICAL CONSERVATION AND BIOLOGY
HERPETOL. REV.	HERPETOLOGICAL REVIEW
HERZOGIA	HERZOGIA
HESPA MITT.	HESPA MITTEILUNGEN
HESS. FLORIST. BRIEFE	HESSISCHE FLORISTISCHE BRIEFE
HOKKAIDO UNIV. COLLECT. SCH. ACAD. PAP. HUSCAP	HOKKAIDO UNIVERSITY COLLECTION OF SCHOLARLY AND ACADEMIC PAPERS: HUSCAP
HOLARCT. ECOL.	HOLARCTIC ECOLOGY
HOLOCENE	HOLOCENE
HOLZ ROH- WERKST.	HOLZ ALS ROH- UND WERKSTOFF
HOLZENERG.-BULL.	HOLZENERGIE-BULLETIN
HOLZFORSCHUNG	HOLZFORSCHUNG
HOLZFORSCH. SCHWEIZ	HOLZFORSCHUNG SCHWEIZ
HOLZFORSCH. HOLZVERWERT.	HOLZFORSCHUNG UND HOLZVERWERTUNG
HOLZ-KUR.	HOLZ-KURIER
HOLZPREISSTAT. - ROHHOLZ	HOLZPREISSTATISTIK - ROHHOLZ
HOLZ, SCHWEIZ. HOLZZTG.	HOLZ, SCHWEIZERISCHE HOLZZEITUNG
HOLZ-ZENT.BL.	HOLZ-ZENTRALBLATT
HOLZZUCHT	HOLZZUCHT
HORTIC. ROMANDE	HORTICULTURE ROMANDE
HOTEL J.	HOTEL JOURNAL
HOTEL TOUR. REV.	HOTEL + TOURISTIK REVUE
HOUILLI BLANCHE	HOUILLE BLANCHE
HOUS. POLICY DEBATE	HOUSING POLICY DEBATE
HUM. DIMENS. WILDL.	HUMAN DIMENSIONS OF WILDLIFE
HUM. ECOL.	HUMAN ECOLOGY
HUM. ORGAN.	HUMAN ORGANIZATION
HUMIC SUBST. ENVIRON.	HUMIC SUBSTANCES IN THE ENVIRONMENT
HYDROBIOLOGIA	HYDROBIOLOGIA
HYDROL. PROCESS.	HYDROLOGICAL PROCESSES
HYDROL. SCI. BULL.	HYDROLOGICAL SCIENCES BULLETIN
HYDROL. SCI. J.	HYDROLOGICAL SCIENCES JOURNAL
HYDROL. WASSERBEWIRTSCH.	HYDROLOGIE UND WASSERBEWIRTSCHAFTUNG
HYDROL. EARTH SYST. SCI.	HYDROLOGY AND EARTH SYSTEM SCIENCES
HYDROL. RES.	HYDROLOGY RESEARCH
HYSTRIX	HYSTRIX
IAHS PUBL.	IAHS PUBLICATION
IALE (INTERNATIONAL ASSOCIATION FOR LANDSCAPE ECOLOGY) BULL.	IALE BULLETIN
IAPS BULL.	IAPS BULLETIN
IAWA J.	IAWA JOURNAL
IBIS	IBIS
IBM-NACHR.	IBM-NACHRICHTEN
ICARUS	ICARUS
ICE CLIM. NEWS	ICE AND CLIMATE NEWS
IEEE J. SEL. TOP. APPL. EARTH OBS. REMOTE SENS.	IEEE JOURNAL OF SELECTED TOPICS IN APPLIED EARTH OBSERVATIONS AND REMOTE SENSING
IEEE TRANS. GEOSCI. REMOTE SENS.	IEEE TRANSACTIONS ON GEOSCIENCE AND REMOTE SENSING
IET IMAGE PROCESS.	IET IMAGE PROCESSING
IFOREST	IFOREST
IM DIENSTE WALD LANDSCH.	IM DIENSTE VON WALD UND LANDSCHAFT
IMPARTIAL	IMPARTIAL
IND. ORGAN.	INDUSTRIELLE ORGANISATION
INFECT. GENET. EVOL.	INFECTION, GENETICS AND EVOLUTION
INFOBL. ARBEITSGR. WALDPLAN. -MANAGE.	INFOBLATT ARBEITSGRUPPE WALDPLANUNG UND -MANAGEMENT
ÎNFO FLORA	INFO FLORA
INFO GESUNDH.	INFO GESUNDHEIT
INF. NAT.SCHUTZ LANDSCH.PFL. NORDWESTDTSCHL.	INFORMATIONEN ZU NATURSCHUTZ UND LANDSCHAFTSPFLEGE IN NORDWESTDEUTSCHLAND
INF. REP. NORTH. FOR. RES. CENT.	INFORMATION REPORT NORTHERN FOREST RESEARCH CENTRE
INF.BER. BAYER. LANDESAMTES WASSERWIRTSCH.	INFORMATIONSBERICHTE DES BAYERISCHEN LANDESAMTES FÜR WASSERWIRTSCHAFT
INF.BL. FORSCH.BEREICHES LANDSCH.	INFORMATIONSBLATT DES FORSCHUNGSBEREICHES LANDSCHAFT
INF.BL. FORSCH.BEREICHES LANDSCH.ÖKOL.	INFORMATIONSBLATT DES FORSCHUNGSBEREICHES LANDSCHAFTSÖKOLOGIE
INF.BL. LANDSCH.	INFORMATIONSBLATT LANDSCHAFT
INF.BL. WALD	INFORMATIONSBLATT WALD
INF.DIENST NAT.SCHUTZ NIEDERSACHS.	INFORMATIONSDIENST NATURSCHUTZ NIEDERSACHSEN
INF. ZÜR. WALD	INFORMATION ZÜRCHER WALD
INF. BOT. ITAL.	INFORMATORE BOTANICO ITALIANO
ING.BIOL. MITT.BL.	INGENIEURBIOLOGIE MITTEILUNGSBLATT
INSECT CONSERV. DIVERS.	INSECT CONSERVATION AND DIVERSITY
INSECTES SOCIAUX	INSECTES SOCIAUX
INST. WASSERWES. MITT.	INSTITUT FÜR WASSERWESEN MITTEILUNGEN
INTEGR. ENVIRO. ASSESS. MANAGE.	INTEGRATED ENVIRONMENTAL ASSESSMENT AND MANAGEMENT
INTEGR. PROJ. NEWS	INTEGRATE PROJECT NEWS
INTEGR. ZOOL.	INTEGRATIVE ZOOLOGY
INTERDISCIP. SCI. REV.	INTERDISCIPLINARY SCIENCE REVIEW
INT. ARCH. PHOTOGRAMM. REMOTE SENS.	INTERNATIONAL ARCHIVES OF PHOTOGRAMMETRY AND REMOTE SENSING
INT. MITT. BODENKD.	INTERNATIONALE MITTEILUNGEN FÜR BODENKUNDE
INT. ENVIRON. AGREEM. POLIT. LAW ECON.	INTERNATIONAL ENVIRONMENTAL AGREEMENTS: POLITICS, LAW AND ECONOMICS
INT. FOR. FIRE NEWS	INTERNATIONAL FOREST FIRE NEWS
INT. FOR. REV.	INTERNATIONAL FORESTRY REVIEW
INT. INNOV.	INTERNATIONAL INNOVATION
INT. J. APPL. EARTH OBS. GEOINF.	INTERNATIONAL JOURNAL OF APPLIED EARTH OBSERVATION AND GEOINFORMATION
INT. J. ARCHIT. URBAN DEV.	INTERNATIONAL JOURNAL OF ARCHITECTURE AND URBAN DEVELOPMENT
INT. J. BIODIVERS. SCI. ECOSYST. SERV. MANAGE.	INTERNATIONAL JOURNAL OF BIODIVERSITY SCIENCE ECOSYSTEM SERVICES AND MANAGEMENT
INT. J. BIOMETEOROL.	INTERNATIONAL JOURNAL OF BIOMETEOROLOGIE
INT. J. CLIMATOL.	INTERNATIONAL JOURNAL OF CLIMATOLOGY
INT. J. COMMUN.	INTERNATIONAL JOURNAL OF COMMUNICATION
INT. J. DISASTER RISK SCI.	INTERNATIONAL JOURNAL OF DISASTER RISK SCIENCE
INT. J. ENG. EDUC.	INTERNATIONAL JOURNAL OF ENGINEERING EDUCATION
INT. J. ENVIRON. HEALTH RES.	INTERNATIONAL JOURNAL OF ENVIRONMENTAL HEALTH RESEARCH
INT. J. EROS. CONTROL ENG.	INTERNATIONAL JOURNAL OF EROSION CONTROL ENGINEERING
INT. J. FRACT.	INTERNATIONAL JOURNAL OF FRACTURE
INT. J. GEOGR. INF. SCI.	INTERNATIONAL JOURNAL OF GEOGRAPHICAL INFORMATION SCIENCE
INT. J. GEOGR. INF. SYST.	INTERNATIONAL JOURNAL OF GEOGRAPHICAL INFORMATION SYSTEMS
INT. J. GREENH. GAS CONTROL	INTERNATIONAL JOURNAL OF GREENHOUSE GAS CONTROL
INT. J. HERIT. DIGIT. ERA	INTERNATIONAL JOURNAL OF HERITAGE IN THE DIGITAL ERA
INT. J. HERIT. STUD.	INTERNATIONAL JOURNAL OF HERITAGE STUDIES
INT. J. HOSP. MANAGE.	INTERNATIONAL JOURNAL OF HOSPITALITY MANAGEMENT
INT. J. LIMNOL.	INTERNATIONAL JOURNAL OF LIMNOLOGY
INT. J. MOD. PHYS. C	INTERNATIONAL JOURNAL OF MODERN PHYSICS C
INT. J. PEST MANAGE.	INTERNATIONAL JOURNAL OF PEST MANAGEMENT
INT. J. PHYTOREMEDIAT.	INTERNATIONAL JOURNAL OF PHYTOREMEDIATION
INT. J. PUBLIC HEALTH	INTERNATIONAL JOURNAL OF PUBLIC HEALTH
INT. J. REMOTE SENS.	INTERNATIONAL JOURNAL OF REMOTE SENSING
INT. J. SPRAY COMBUST. DYN.	INTERNATIONAL JOURNAL OF SPRAY AND COMBUSTION DYNAMICS
INT. J. SYST. EVOL. MICROBIOL.	INTERNATIONAL JOURNAL OF SYSTEMATIC AND EVOLUTIONARY MICROBIOLOGY
INT. J. WILDERNESS	INTERNATIONAL JOURNAL OF WILDERNESS
INT. J. WILDLAND FIRE	INTERNATIONAL JOURNAL OF WILDLAND FIRE
INT. LICHENOL. NEWSL.	INTERNATIONAL LICHENOLOGICAL NEWSLETTER
INT. MARK. REV.	INTERNATIONAL MARKETING REVIEW
INT. PEAT J.	INTERNATIONAL PEAT JOURNAL
INT. REG. SCI. REV.	INTERNATIONAL REGIONAL SCIENCE REVIEW
INT. SOC. SCI. J.	INTERNATIONAL SOCIAL SCIENCE JOURNAL
INT. TREE CROPS J.	INTERNATIONAL TREE CROPS JOURNAL
INVEST. CIENC.	INVESTIGACION Y CIENCIA
IOWA AGRIC. EXP. STN. RES. BULL.	IOWA AGRICULTURAL EXPERIMENT STATION RESEARCH BULLETIN
IR. NAT. J.	IRISH NATURALISTS JOURNAL
ISOT. ENVIRON. HEALTH STUD.	ISOTOPES IN ENVIRONMENTAL AND HEALTH STUDIES
ISPRS J. PHOTOGRAMM. REMOTE SENS.	ISPRS JOURNAL OF PHOTOGRAMMETRY AND REMOTE SENSING
ISR. J. PLANT SCI.	ISRAEL JOURNAL OF PLANT SCIENCE
ITAL. FOR. MONT.	ITALIA FORESTALE E MONTANA
ITAL. J. FOR. MT. ENVIRON.	ITALIAN JOURNAL OF FOREST AND MOUNTAIN ENVIRONMENTS
ITC-JOURNAL	ITC-JOURNAL
JAGD NAT.	JAGD UND NATUR
JAHRB. SCHWEIZ. GES. UR- FRÜHGESCH.	JAHRBUCH DER SCHWEIZERISCHEN GESELLSCHAFT FÜR UR- UND FRÜHGESCHICHTE
JAHRB. SCHWEIZ. NAT.FORSCH. GES.	JAHRBUCH DER SCHWEIZERISCHEN NATURFORSCHENDEN GESELLSCHAFT
JAHRB. SCHWEIZ. WALD- HOLZWIRTSCH.	JAHRBUCH DER SCHWEIZERISCHEN WALD- UND HOLZWIRTSCHAFT
JAHRB. ST. GALLISCHE NAT.WISS. GES.	JAHRBUCH DER ST. GALLISCHEN NATURWISSENSCHAFTLICHEN GESELLSCHAFT
JAHRB. OBERAARGAU	JAHRBUCH DES OBERAARGAUS
JAHRB. SCHWEIZ. WASSERWIRTSCHAFTS-VERB.	JAHRBUCH DES SCHWEIZERISCHEN WASSERWIRTSCHAFTSVERBANDES
JAHRB. VER. SCHUTZ ALP.PFLANZEN -TIERE	JAHRBUCH DES VEREINS ZUM SCHUTZE DER ALPENPFLANZEN UND -TIERE
JAHRB. NAT.SCHUTZ LANDSCH.PFL.	JAHRBUCH FÜR NATURSCHUTZ UND LANDSCHAFTSPFLEGE
JAHRB. SCHWEIZ. AKAD. NAT.WISS.	JAHRBUCH SCHWEIZERISCHE AKADEMIE DER NATURWISSENSCHAFTEN
JAHRB. THUNER- BRIENZERSEE	JAHRBUCH VOM THUNER- UND BRIENZERSEE
JAHRB. ZÜR.SEE	JAHRBUCH VOM ZÜRICHSEE
JAHRESBER. NAT.FORSCH. GES. GRAUBÜNDEN	JAHRESBERICHT DER NATURFORSCHENDEN GESELLSCHAFT GRAUBÜNDEN
JAHRESBER. LIGNUM	JAHRESBERICHT LIGNUM
JAHRESH. VER. VATERL. NAT.KD. WÜRTT.	JAHRESHEFTE DES VEREINS FÜR VATERLÄNDISCHE NATURKUNDE IN WÜRTTEMBERG
JKI DATA SHEETS	JKI DATA SHEETS
J. CAN. SCI. TERRE	JOURNAL CANADIEN DES SCIENCES DE LA TERRE
J. J.E.C.	JOURNAL DES J.E.C
J. FOR. SUISSE	JOURNAL FORESTIER SUISSE
J. NAT. CONSERV.	JOURNAL FOR NATURE CONSERVATION
J. ORNITHOL.	JOURNAL FÜR ORNITHOLOGIE
J. ADVERT. RES.	JOURNAL OF ADVERTISING RESEARCH
J. AEROSOL SCI.	JOURNAL OF AEROSOL SCIENCE
J. AESTHET. ART CRITISISM	JOURNAL OF AESTHETICS AND ART CRITICISM
J. AGRIC. FOOD CHEM.	JOURNAL OF AGRICULTURAL AND FOOD CHEMISTRY
J. AGRIC. RES.	JOURNAL OF AGRICULTURAL RESEARCH
J. AGRIC. SCI.	JOURNAL OF AGRICULTURAL SCIENCE
J. ANAT.	JOURNAL OF ANATOMY
J. ANIM. ECOL.	JOURNAL OF ANIMAL ECOLOGY
J. ANIM. PHYSIOL. ANIM. NUTR.	JOURNAL OF ANIMAL PHYSIOLOGY AND ANIMAL NUTRITION
J. APIC. RES.	JOURNAL OF APICULTURAL RESEARCH
J. APPL. BEHAV. ANAL.	JOURNAL OF APPLIED BEHAVIOR ANALYSIS
J. APPL. ECOL.	JOURNAL OF APPLIED ECOLOGY
J. APPL. ENTOMOL.	JOURNAL OF APPLIED ENTOMOLOGY
J. APPL. METEOROL. CLIMATOL.	JOURNAL OF APPLIED METEOROLOGY AND CLIMATOLOGY
J. APPL. METEOROL.	JOURNAL OF APPLIED METEOROLOGY
J. APPL. REMOTE SENS.	JOURNAL OF APPLIED REMOTE SENSING
J. APPL. SOC. PSYCHOL.	JOURNAL OF APPLIED SOCIAL PSYCHOLOGY
J. ARCHAEOL. SCI.	JOURNAL OF ARCHAEOLOGICAL SCIENCE
J. ARCHIT. PLAN. RES.	JOURNAL OF ARCHITECTURAL AN PLANNING RESEARCH
J. ARID ENVIRON.	JOURNAL OF ARID ENVIRONMENTS
J. AVIAN BIOL.	JOURNAL OF AVIAN BIOLOGY
J. BACTERIOL.	JOURNAL OF BACTERIOLOGY
J. BIOGEOGR.	JOURNAL OF BIOGEOGRAPHY
J. BIOL. CHEM.	JOURNAL OF BIOLOGICAL CHEMISTRY
J. BIOMETEOROL.	JOURNAL OF BIOMETEOROLOGY
J. BIOPHYS. CHEM.	JOURNAL OF BIOPHYSICAL CHEMISTRY
J. BRYOL.	JOURNAL OF BRYOLOGY
J. BUS. RES.	JOURNAL OF BUSINESS RESEARCH
J. CHEM. ECOL.	JOURNAL OF CHEMICAL ECOLOGY
J. CHEM. PHYS.	JOURNAL OF CHEMICAL PHYSICS
J. CLIM. APPL. METEOROL.	JOURNAL OF CLIMATE AND APPLIED METEOROLOGY
J. CLIM.	JOURNAL OF CLIMATE
J. COAST. RES.	JOURNAL OF COASTAL RESEARCH
J. COMMUNITY APPL. SOC. PSYCHOL.	JOURNAL OF COMMUNITY & APPLIED SOCIAL PSYCHOLOGY
J. COMP. NEUROL.	JOURNAL OF COMPARATIVE NEUROLOGY
J. COMP. PHYSIOL.	JOURNAL OF COMPARATIVE PHYSIOLOGY
J. COMPUT. GRAPH. STAT.	JOURNAL OF COMPUTATIONAL AND GRAPHICAL STATISTICS
J. CONSUM. RES.	JOURNAL OF CONSUMER RESEARCH
J. CONTAM. HYDROL.	JOURNAL OF CONTAMINANT HYDROLOGY
J. CULT. HERIT.	JOURNAL OF CULTURAL HERITAGE
J. DEV. STUD.	JOURNAL OF DEVELOPMENT STUDIES
J. ECOL.	JOURNAL OF ECOLOGY
J. ECON. ENTOMOL.	JOURNAL OF ECONOMIC ENTOMOLOGY
J. ECON. GEOGR.	JOURNAL OF ECONOMIC GEOGRAPHY
J. ECOTOUR.	JOURNAL OF ECOTOURISM
J. ENDOCRINOL.	JOURNAL OF ENDOCRINOLOGY
J. ENG. MECH.	JOURNAL OF ENGINEERING MECHANICS
J. ENVIRON. ECON. MANAGE.	JOURNAL OF ENVIRONMENTAL ECONOMICS AND MANAGEMENT
J. ENVIRON. EDUC.	JOURNAL OF ENVIRONMENTAL EDUCATION
J. ENVIRON. MANAGE.	JOURNAL OF ENVIRONMENTAL MANAGEMENT
J. ENVIRON. MONIT.	JOURNAL OF ENVIRONMENTAL MONITORING
J. ENVIRON. PLAN. MANAGE.	JOURNAL OF ENVIRONMENTAL PLANNING AND MANAGEMENT
J. ENVIRON. POLICY PLAN.	JOURNAL OF ENVIRONMENTAL POLICY AND PLANNING
J. ENVIRON. PSYCHOL.	JOURNAL OF ENVIRONMENTAL PSYCHOLOGY
J. ENVIRON. QUAL.	JOURNAL OF ENVIRONMENTAL QUALITY
J. ENVIRON. RADIOACT.	JOURNAL OF ENVIRONMENTAL RADIOACTIVITY
J. EPIDEMIOL. COMMUNITY HEALTH	JOURNAL OF EPIDEMIOLOGY AND COMMUNITY HEALTH
J. EUKARYOT. MICROBIOL.	JOURNAL OF EUKARYOTIC MICROBIOLOGY
J. EVOL. BIOL.	JOURNAL OF EVOLUTIONARY BIOLOGY
J. EXP. BIOL.	JOURNAL OF EXPERIMENTAL BIOLOGY
J. EXP. BOT.	JOURNAL OF EXPERIMENTAL BOTANY
J. EXP. SOC. PSYCHOL.	JOURNAL OF EXPERIMENTAL SOCIAL PSYCHOLOGY
J. FIELD ARCHAEOL.	JOURNAL OF FIELD ARCHAEOLOGY
J. FLOOD RISK MANAGE.	JOURNAL OF FLOOD RISK MANAGEMENT
J. FLUID MECH.	JOURNAL OF FLUID MECHANICS
J. FOR. ECON.	JOURNAL OF FOREST ECONOMICS
J. FOR. RES.	JOURNAL OF FOREST RESEARCH
J. FOR.	JOURNAL OF FORESTRY
J. GEN. VIROL.	JOURNAL OF GENERAL VIROLOGY
J. GEOCHEM. EXPLOR.	JOURNAL OF GEOCHEMICAL EXPLORATION
J. GEOPHYS. RES. ATMOS.	JOURNAL OF GEOPHYSICAL RESEARCH ATMOSPHERES
J. GEOPHYS. RES.: BIOGEOSCI.	JOURNAL OF GEOPHYSICAL RESEARCH: BIOGEOSCIENCES
J. GEOPHYS. RES. EARTH SURF.	JOURNAL OF GEOPHYSICAL RESEARCH EARTH SURFACE
J. GEOPHYS. RES. F: EARTH SURF.	JOURNAL OF GEOPHYSICAL RESEARCH: EARTH SURFACE
J. GEOPHYS. RES.	JOURNAL OF GEOPHYSICAL RESEARCH
J. GEOTECH. GEOENVIRON. ENG.	JOURNAL OF GEOTECHNICAL AND GEOENVIRONMENTAL ENGINEERING
J. GLACIOL.	JOURNAL OF GLACIOLOGY
J. HERED.	JOURNAL OF HEREDITY
J. HERPETOL.	JOURNAL OF HERPETOLOGY
J. HIST. GEOGR.	JOURNAL OF HISTORICAL GEOGRAPHY
J. HOUS. ELDER.	JOURNAL OF HOUSING FOR THE ELDERLY
J. HYDRAUL. ENG.	JOURNAL OF HYDRAULIC ENGINEERING
J. HYDRAUL. RES.	JOURNAL OF HYDRAULIC RESEARCH
J. HYDROL. ENG.	JOURNAL OF HYDROLOGIC ENGINEERING
J. HYDROL.	JOURNAL OF HYDROLOGY
J. HYDROMETEOROL.	JOURNAL OF HYDROMETEOROLOGY
J. HYMENOPTERA RES.	JOURNAL OF HYMENOPTERA RESEARCH
J. INORG. BIOCHEM.	JOURNAL OF INORGANIC BIOCHEMISTRY
J. INSECT BEHAV.	JOURNAL OF INSECT BEHAVIOR
J. INSECT CONSERV.	JOURNAL OF INSECT CONSERVATION
J. INSECT PHYSIOL.	JOURNAL OF INSECT PHYSIOLOGY
J. INTERDISCIP. HIST.	JOURNAL OF INTERDISCIPLINARY HISTORY
J. INTERPRET. RES.	JOURNAL OF INTERPRETATION RESEARCH
J. IRRIG. DRAIN. ENG.	JOURNAL OF IRRIGATION AND DRAINAGE ENGINEERING
J. JPN. BOT.	JOURNAL OF JAPANESE BOTANY
J. LAND USE SCI.	JOURNAL OF LAND USE SCIENCE
J. LEIS. RES.	JOURNAL OF LEISURE RESEARCH
J. LIMNOL.	JOURNAL OF LIMNOLOGY
J. MAGN. MAGN. MATER.	JOURNAL OF MAGNETISM AND MAGNETIC MATERIALS
J. MAMMAL.	JOURNAL OF MAMMALOGY
J. MAR. RES.	JOURNAL OF MARINE RESEARCH
J. MARK. MANAGE.	JOURNAL OF MARKETING MANAGEMENT
J. MARK.	JOURNAL OF MARKETING
J. MARK. RES.	JOURNAL OF MARKETING RESEARCH
J. MATH. BIOL.	JOURNAL OF MATHEMATICAL BIOLOGY
J. MICROBIOL. METHODS	JOURNAL OF MICROBIOLOGICAL METHODS
J. MICROSC.	JOURNAL OF MICROSCOPY
J. MOL. BIOL.	JOURNAL OF MOLECULAR BIOLOGY
J. MOL. ECOL.	JOURNAL OF MOLECULAR ECOLOGY
J. MORPHOL.	JOURNAL OF MORPHOLOGY
J. MT. SCI.	JOURNAL OF MOUNTAIN SCIENCE
J. MULTIVAR. ANAL.	JOURNAL OF MULTIVARIATE ANALYSIS
J. NAT. HIST.	JOURNAL OF NATURAL HISTORY
J. NEMATOL.	JOURNAL OF NEMATOLOGY
J. NONPARAMETRIC STAT.	JOURNAL OF NONPARAMETRIC STATISTICS
J. OPT. TECHNOL.	JOURNAL OF OPTICAL TECHNOLOGY
J. OUTDOOR RECREAT. TOUR.	JOURNAL OF OUTDOOR RECREATION AND TOURISM
J. OUTDOOR RECREAT. STUD.	JOURNAL OF OUTDOOR RECREATION STUDIES
J. PALEOLIMNOL.	JOURNAL OF PALEOLIMNOLOGY
J. PARK RECREAT. ADM.	JOURNAL OF PARK AND RECREATION ADMINISTRATION
J. PERS. SOC. PSYCHOL.	JOURNAL OF PERSONALITY AND SOCIAL PSYCHOLOGY
J. PHYCOL.	JOURNAL OF PHYCOLOGY
J. PHYS. OCEANOGR.	JOURNAL OF PHYSICAL OCEANOGRAPHY
J. PHYS.	JOURNAL OF PHYSICS
J. PLACE MANAG. DEV.	JOURNAL OF PLACE MANAGEMENT AND DEVELOPMENT
J. PLAN. LIT.	JOURNAL OF PLANNING LITERATURE
J. PLANT ECOL.	JOURNAL OF PLANT ECOLOGY
J. PLANT NUTR. SOIL SCI.	JOURNAL OF PLANT NUTRITION AND SOIL SCIENCE
J. PLANT NUTR.	JOURNAL OF PLANT NUTRITION
J. PLANT PHYSIOL.	JOURNAL OF PLANT PHYSIOLOGY
J. PLANT RES.	JOURNAL OF PLANT RESEARCH
J. PROTEOMICS	JOURNAL OF PROTEOMICS
J. QUAT. SCI.	JOURNAL OF QUATERNARY SCIENCE
J. RADIOANAL. NUCL. CHEM.	JOURNAL OF RADIOANALYTICAL AND NUCLEAR CHEMISTRY
J. RANGE MANAGE.	JOURNAL OF RANGE MANAGEMENT
J. REAL ESTATE FINANC. ECON.	JOURNAL OF REAL ESTATE FINANCE AND ECONOMICS
J. RISK UNCERTAINTY	JOURNAL OF RISK AND UNCERTAINTY
J. RURAL STUD.	JOURNAL OF RURAL STUDIES
J. SERV. RES.	JOURNAL OF SERVICE RESEARCH
J. SICHUAN FOR. SCI. TECHNOL.	JOURNAL OF SICHUAN FORESTRY SCIENCE AND TECHNOLOGY
J. SOC. ISSUES	JOURNAL OF SOCIAL ISSUES
J. SOIL WATER CONSERV.	JOURNAL OF SOIL AND WATER CONSERVATION
J. SOILS SEDIMENTS	JOURNAL OF SOILS AND SEDIMENTS
J. SOIL SCI.	JOURNAL OF SOIL SCIENCE
J. SPORTS SCI.	JOURNAL OF SPORTS SCIENCES
J. STAT. COMPUT. SIMUL.	JOURNAL OF STATISTICAL COMPUTATION AND SIMULATION
J. STAT. PHYS.	JOURNAL OF STATISTICAL PHYSICS
J. STAT. PLAN. INFERENCE	JOURNAL OF STATISTICAL PLANNING AND INFERENCE
J. STEROID BIOCHEM. MOL. BIOL.	JOURNAL OF STEROID BIOCHEMISTRY AND MOLECULAR BIOLOGY
J. SUSTAINABLE AGRIC.	JOURNAL OF SUSTAINABLE AGRICULTURE
J. SUSTAINABLE FOR.	JOURNAL OF SUSTAINABLE FORESTRY
J. SUSTAINABLE TOUR.	JOURNAL OF SUSTAINABLE TOURISM
J. TERRAMECH.	JOURNAL OF TERRAMECHANICS
J. AIR WASTE MANAGE. ASSOC.	JOURNAL OF THE AIR AND WASTE MANAGEMENT ASSOCIATION
J. AIR POLLUT. CONTROL ASSOC.	JOURNAL OF THE AIR POLLUTION CONTROL ASSOCIATION
J. AM. PLAN. ASSOC.	JOURNAL OF THE AMERICAN PLANNING ASSOCIATION
J. AM. SOC. HORTIC. SCI.	JOURNAL OF THE AMERICAN SOCIETY FOR HORTICULTURAL SCIENCE
J. AM. STAT. ASSOC.	JOURNAL OF THE AMERICAN STATISTICAL ASSOCIATION
J. AM. WATER RESOUR. ASSOC.	JOURNAL OF THE AMERICAN WATER RESOURCES ASSOCIATION
J. ATMOS. SCI.	JOURNAL OF THE ATMOSPHERIC SCIENCES
J. BR. GRASSL. SOC.	JOURNAL OF THE BRITISH GRASSLAND SOCIETY
J. BR. WATERWORKS ASSOC.	JOURNAL OF THE BRITISH WATERWORKS ASSOCIATION
J. FAC. AGRIC., SHINSHU UNIV.	JOURNAL OF THE FACULTY OF AGRICULTURE, SHINSHU UNIVERSITY
J. FAC. SCI. HOKKAIDO UNIV.	JOURNAL OF THE FACULTY OF SCIENCE, HOKKAIDO UNIVERSITY
J. HATTORI BOT. LAB.	JOURNAL OF THE HATTORI BOTANICAL LABORATORY
J. KANS. ENTOMOL. SOC.	JOURNAL OF THE KANSAS ENTOMOLOGICAL SOCIETY
J. NORTH AM. BENTHOLOGICAL SOC.	JOURNAL OF THE NORTH AMERICAN BENTHOLOGICAL SOCIETY
J. OPT. SOC. AM.	JOURNAL OF THE OPTICAL SOCIETY OF AMERICA
J. THEORET. BIOL.	JOURNAL OF THEORETICAL BIOLOGY
J. R. STAT. SOC.	JOURNAL OF THE ROYAL STATISTICAL SOCIETY
J. RUSSELL SOC.	JOURNAL OF THE RUSSELL SOCIETY
J. SCI. FOOD AGRIC.	JOURNAL OF THE SCIENCE OF FOOD AND AGRICULTURE
J. TIME SER. ANAL.	JOURNAL OF TIME SERIES ANALYSIS
J. TOUR. STUD.	JOURNAL OF TOURISM STUDIES
J. TRACE ELEM. MED. BIOL.	JOURNAL OF TRACE ELEMENTS IN MEDICINE AND BIOLOGY
J. TRAVEL RES.	JOURNAL OF TRAVEL RESEARCH
J. TROP. ECOL.	JOURNAL OF TROPICAL ECOLOGY
J. TROP. FOR. SCI.	JOURNAL OF TROPICAL FOREST SCIENCE
J. TROP. GEOGR.	JOURNAL OF TROPICAL GEOGRAPHY
J. URBAN TECHNOL.	JOURNAL OF URBAN TECHNOLOGY
J. VEG. SCI.	JOURNAL OF VEGETATION SCIENCE
J. VOLCANOL. GEOTHERM. RES.	JOURNAL OF VOLCANOLOGY AND GEOTHERMAL RESEARCH
J. WILDL. DIS.	JOURNAL OF WILDLIFE DISEASES
J. WILDL. MANAGE.	JOURNAL OF WILDLIFE MANAGEMENT
J. WILDL. RES.	JOURNAL OF WILDLIFE RESEARCH
J. WIND ENG. IND. AERODYN.	JOURNAL OF WIND ENGINEERING AND INDUSTRIAL AERODYNAMICS
J. ZOOL. (LONDON)	JOURNAL OF ZOOLOGY
J. SUISSE BOIS	JOURNAL SUISSE DU BOIS
JOVE J. VIS. EXP.	JOVE JOURNAL OF VISUALIZED EXPERIMENTS
JRC SCI. TECH. REP.	JRC SCIENTIFIC AND TECHNICAL REPORTS
KARSTENIA	KARSTENIA
KEW BULL.	KEW BULLETIN
KLEINE SENCKENB.R.	KLEINE SENCKENBERGREIHE
KÖLN. GEOGR. ARB.	KÖLNER GEOGRAPHISCHE ARBEITEN
KOMMUNALMAG.	KOMMUNALMAGAZIN
KOMPET.-ZENT. HOLZ	KOMPETENZ-ZENTRUM HOLZ
KORA BER.	KORA BERICHT
LAND DEGRAD. DEV.	LAND DEGRADATION & DEVELOPMENT
LAND ECON.	LAND ECONOMICS
LANDESHYDROL. -GEOL., MITT.	LANDESHYDROLOGIE UND -GEOLOGIE, MITTEILUNG
LANDSC. ECOL. ENG.	LANDSCAPE AND ECOLOGICAL ENGINEERING
LANDSC. URBAN PLAN.	LANDSCAPE AND URBAN PLANNING
LANDSC. ECOL.	LANDSCAPE ECOLOGY
LANDSC. HIST.	LANDSCAPE HISTORY
LANDSC. J.	LANDSCAPE JOURNAL
LANDSC. ONLINE	LANDSCAPE ONLINE
LANDSC. PLAN.	LANDSCAPE PLANNING
LANDSC. RES.	LANDSCAPE RESEARCH
LANDSCH. AARGAU	LANDSCHAFT AARGAU
LANDSCH.ENTWICKL. UMWELTFORSCH.	LANDSCHAFTSENTWICKLUNG UND UMWELTFORSCHUNG
LANDSCH.GENES. LANDSCH.ÖKOL.	LANDSCHAFTSGENESE UND LANDSCHAFTSÖKOLOGIE
LANDSCH.ÖKOL. UMWELTFORSCH.	LANDSCHAFTSÖKOLOGIE UND UMWELTFORSCHUNG
LANDSCH.PFL. NAT.SCHUTZ THÜRING.	LANDSCHAFTSPFLEGE UND NATURSCHUTZ IN THÜRINGEN
LANDSCH.PFL. VEG.KD.	LANDSCHAFTSPFLEGE UND VEGETATIONSKUNDE
LANDSLIDES	LANDSLIDES
LAND USE POLICY	LAND USE POLICY
LANDWIRTSCH. FORSCH.	LANDWIRTSCHAFTLICHE FORSCHUNG
LANDWIRTSCH. JAHRB. SCHWEIZ	LANDWIRTSCHAFTLICHES JAHRBUCH DER SCHWEIZ
LANG. RESOUR. EVAL.	LANGUAGE RESOURCES AND EVALUATION
LAUFENER SEMIN.BEITR.	LAUFENER SEMINARBEITRÄGE
LEAFL. AGRIC. RES. ORGAN., DIV. FOR.	LEAFLET AGRICULTURAL RESEARCH ORGANIZATION, DIVISION OF FORESTRY
LECT. NOTES EARTH SCI.	LECTURE NOTES IN EARTH SCIENCES
LEIS. SCI.	LEISURE SCIENCES
LEITZ, MITT. WISS. TECH.	LEITZ, MITTEILUNGEN FÜR WISSENSCHAFT UND TECHNIK
LETT. PRO SILVA FR.	LETTRE DE PRO SILVA FRANCE
LICHENOLOGIST	LICHENOLOGIST
LIMNOLOGICA	LIMNOLOGICA
LIMNOL. AKTUELL	LIMNOLOGIE AKTUELL
LIMOSA	LIMOSA
LINDBERGIA	LINDBERGIA
LINEA ECOL.	LINEA ECOLOGICA
LINZ. BIOL. BEITR.	LINZER BIOLOGISCHE BEITRÄGE
LLOYDIA	LLOYDIA
LÖBF-MITT., LANDESANST. ÖKOL. BODENORDN. FORSTEN, LANDESAMT AGRARORDN. NORDRH.-WESTFAL.	LÖBF-MITTEILUNGEN, LANDESANSTALT FÜR ÖKOLOGIE, BODENORDNUNG UND FORSTEN / LANDESAMT FÜR AGRARORDNUNG, NORDRHEIN-WESTFALEN
LÖBF-SCHR.REIHE, LANDESANST. ÖKOL. BODENORDN. FORSTEN NORDRH.-WESTFAL.	LÖBF-SCHRIFTENREIHE, LANDESANSTALT FÜR ÖKOLOGIE, BODENORDNUNG UND FORSTEN, NORDRHEIN-WESTFALEN
LOCAL LAND SOIL NEWS	LOCAL LAND AND SOIL NEWS
LÖLF-MITT., LANDESANST. ÖKOL. LANDSCH.ENTWICKL. FORSTPLAN., NORDRH.-WESTFAL.	LÖLF-MITTEILUNGEN, LANDESANSTALT FÜR ÖKOLOGIE, LANDSCHAFTSENTWICKLUNG UND FORSTPLANUNG, NORDRHEIN-WESTFALEN
LUNDQUA REP.	LUNDQUA REPORT
MADAG. CONSERV. DEV.	MADAGASCAR CONSERVATION AND DEVELOPMENT
MALAYAN J. TROP. GEOGR.	MALAYAN JOURNAL OF TROPICAL GEOGRAPHY
MALAYAN NAT. J.	MALAYAN NATURE JOURNAL
MALAYS. FOR.	MALAYSIAN FORESTER
MAMM. BIOL.	MAMMALIAN BIOLOGY
MAMM. GENOME	MAMMALIAN GENOME
MAMMALIA	MAMMALIA
MAMM. REV.	MAMMAL REVIEW
MAPLE TECH. NEWSL.	MAPLE TECHNICAL NEWSLETTER
MATÉR. CARTE GÉOL. SUISSE	MATÉRIAUX POUR LA CARTE GÉOLOGIQUE DE LA SUISSE
MATÉR. LEVÉ GÉOBOT. SUISSE	MATÉRIAUX POUR LE LEVÉ GÉOBOTANIQUE DE LA SUISSE
MATÉR. HYDROL. SUISSE	MATÉRIAUX POUR L'HYDROLOGIE DE LA SUISSE
MATH. COMPUT. SIMUL.	MATHEMATICS AND COMPUTERS IN SIMULATION
MEAS. SCI. TECHNOL.	MEASUREMENT SCIENCE AND TECHNOLOGY
MEDD. NOR. INST. SKOGFORSK.	MEDDELELSER FRA NORSK INSTITUTT FOR SKOGFORSKNING
MEDED. LANDBOUWHOOGESCH. WAGENING.	MEDEDELINGEN VAN DE LANDBOUWHOOGESCHOOL TE WAGENINGEN
MÉM. SOC. VAUD. SCI. NAT.	MÉMOIRES DE LA SOCIÉTÉ VAUDOISE DES SCIENCES NATURELLES
MERKBL. FORSTPRAKT. EIDGENÖSS. ANST. FORSTL. VERS.WES.	MERKBLATT FÜR DEN FORSTPRAKTIKER EIDG. ANSTALT FÜR DAS FORSTLICHE VERSUCHSWESEN
MERKBL. PRAX.	MERKBLATT FÜR DIE PRAXIS
METEROL. APPL.	METEOROLOGICAL APPLICATION
METEOROL. Z.	METEOROLOGISCHE ZEITSCHRIFT
METEOROL. ATMOS. PHYS.	METEOROLOGY AND ATMOSPHERIC PHYSICS
METHODS ECOL. EVOL.	METHODS IN ECOLOGY AND EVOLUTION
MEYLANIA	MEYLANIA
MICOL. ITAL.	MICOLOGIA ITALIANA
MICROB. ENVIRON.	MICROBES AND ENVIRONMENTS
MICROB. BIOTECHNOL.	MICROBIAL BIOTECHNOLOGY
MICROB. ECOL.	MICROBIAL ECOLOGY
MICROBIOL. RES.	MICROBIOLOGICAL RESEARCH
MIKROSKOPIE	MIKROSKOPIE
MINERALOG. MAG.	MINERALOGICAL MAGAZINE
MITIGATION ADAPT. STRATEG. GLOB. CHANG.	MITIGATION AND ADAPTATION STRATEGIES FOR GLOBAL CHANGE
MITT. BIOL. BUNDESANST. LAND- FORSTWIRTSCH., BERL.-DAHL.	MITTEILUNGEN AUS DER BIOLOGISCHEN BUNDESANSTALT FÜR LAND- UND FORSTWIRTSCHAFT, BERLIN-DAHLEM
MITT. NORDDTSCH. NAT.SCHUTZAKAD.	MITTEILUNGEN AUS DER NORDDEUTSCHEN NATURSCHUTZAKADEMIE (NNA)
MITT. STAATSFORSTVERWALT. BAYERNS	MITTEILUNGEN AUS DER STAATSFORSTVERWALTUNG BAYERNS
MITT. AARGAU. NAT.FORSCH. GES.	MITTEILUNGEN DER AARGAUISCHEN NATURFORSCHENDEN GESELLSCHAFT
MITT. ABT. BOT. LANDESMUS. JOANNEUM GRAZ	MITTEILUNGEN DER ABTEILUNG FÜR BOTANIK AM LANDESMUSEUM JOANNEUM IN GRAZ
MITT. ABT. FORSTL. BIOM. UNIV. FREIBG.	MITTEILUNGEN DER ABTEILUNG FÜR FORSTLICHE BIOMETRIE DER UNIVERSITÄT FREIBURG
MITT. ARB.GEM. GEOBOT. SCHLESW.-HOLST. HAMBG.	MITTEILUNGEN DER ARBEITSGEMEINSCHAFT GEOBOTANIK IN SCHLESWIG-HOLSTEIN UND HAMBURG
MITT. BUNDESFORSCH.ANST. FORST- HOLZWIRTSCH.	MITTEILUNGEN DER BUNDESFORSCHUNGSANSTALT FÜR FORST- UND HOLZWIRTSCHAFT
MITT. DTSCH. BODENKDL. GES.	MITTEILUNGEN DER DEUTSCHEN BODENKUNDLICHEN GESELLSCHAFT
MITT. DTSCH. DENDROL. GES.	MITTEILUNGEN DER DEUTSCHEN DENDROLOGISCHEN GESELLSCHAFT
MITT. DTSCH. GES. ALLG. ANGEW. ENTOMOL.	MITTEILUNGEN DER DEUTSCHEN GESELLSCHAFT FÜR ALLGEMEINE UND ANGEWANDTE ENTOMOLOGIE
MITT. DTSCH. MALAKOZOOL. GES.	MITTEILUNGEN DER DEUTSCHEN MALAKOZOOLOGISCHEN GESELLSCHAFT
MITT. EIDGENÖSS. FORSCH.ANST. WALD SCHNEE LANDSCH.	MITTEILUNGEN DER EIDG. FORSCHUNGSANSTALT FÜR WALD, SCHNEE UND LANDSCHAFT
MITT. ENTOMOL. GES. BASEL	MITTEILUNGEN DER ENTOMOLOGISCHEN GESELLSCHAFT BASEL
MITT. FLORIST.-SOZIOL. ARB.GEM.	MITTEILUNGEN DER FLORISTISCH-SOZIOLOGISCHEN ARBEITSGEMEINSCHAFT
MITT. FORSTL. BUNDES-VERS.ANST. WIEN	MITTEILUNGEN DER FORSTLICHEN BUNDES-VERSUCHSANSTALT WIEN
MITT. FORSTL. VERS.- FORSCH.ANST. BADEN-WÜRTT.	MITTEILUNGEN DER FORSTLICHEN VERSUCHS- UND FORSCHUNGSANSTALT BADEN-WÜRTTEMBERG
MITT. GEOGR.-ETHNOGR. GES. ZÜR.	MITTEILUNGEN DER GEOGRAPHISCH-ETHNOGRAPHISCHEN GESELLSCHAFT ZÜRICH
MITT. GES. BIBL.WES. DOK. LANDBAUES	MITTEILUNGEN DER GESELLSCHAFT FÜR BIBLIOTHEKSWESEN UND DOKUMENTATION DES LANDBAUES
MITT. HESS. LANDESFORSTVERWALT.	MITTEILUNGEN DER HESSISCHEN LANDESFORSTVERWALTUNG
MITT. INTERESSENGEM. AVIFAUNA DDR	MITTEILUNGEN DER INTERESSENGEMEINSCHAFT AVIFAUNA DER DDR
MITT. INT. BODENKDL. GES.	MITTEILUNGEN DER INTERNATIONALEN BODENKUNDLICHEN GESELLSCHAFT
MITT. NAT.FORSCH. GES. KANTON GLARUS	MITTEILUNGEN DER NATURFORSCHENDEN GESELLSCHAFT DES KANTONS GLARUS
MITT. NAT.FORSCH. GES. KANTON SOLOTHURN	MITTEILUNGEN DER NATURFORSCHENDEN GESELLSCHAFT DES KANTONS SOLOTHURN
MITT. NAT.FORSCH. GES. BERN	MITTEILUNGEN DER NATURFORSCHENDEN GESELLSCHAFT IN BERN
MITT. NAT.FORSCH. GES. LUZERN	MITTEILUNGEN DER NATURFORSCHENDEN GESELLSCHAFT LUZERN
MITT. NAT.FORSCH. GES. SCHAFFHAUSEN 	MITTEILUNGEN DER NATURFORSCHENDEN GESELLSCHAFT SCHAFFHAUSEN
MITT. NAT.WISS. GES. THUN	MITTEILUNGEN DER NATURWISSENSCHAFTLICHEN GESELLSCHAFT THUN
MITT. NAT.WISS. GES. WINTERTHUR	MITTEILUNGEN DER NATURWISSENSCHAFTLICHEN GESELLSCHAFT WINTERTHUR
MITT. NIEDERSÄCHS. FORSTL. VERS.ANST.	MITTEILUNGEN DER NIEDERSÄCHSISCHEN FORSTLICHEN VERSUCHSANSTALT
MITT. ÖSTERR. BODENKDL. GES.	MITTEILUNGEN DER ÖSTERREICHISCHEN BODENKUNDLICHEN GESELLSCHAFT
MITT. ÖSTERR. GEOGR. GES.	MITTEILUNGEN DER ÖSTERREICHISCHEN GEOGRAPHISCHEN GESELLSCHAFT
MITT. SCHWEIZ. ENTOMOL. GES.	MITTEILUNGEN DER SCHWEIZERISCHEN ENTOMOLOGISCHEN GESELLSCHAFT
MITT. THURGAU. NAT.FORSCH. GES.	MITTEILUNGEN DER THURGAUISCHEN NATURFORSCHENDEN GESELLSCHAFT
MITT. VERS.ANST. WASSERBAU HYDROL. GLAZIOL. EIDGENÖSS. TECH. HOCHSCH. ZÜR.	MITTEILUNGEN DER VERSUCHSANSTALT FÜR WASSERBAU, HYDROLOGIE UND GLAZIOLOGIE AN DER EIDG. TECHNISCHEN HOCHSCHULE ZÜRICH
MITT. ARB.KR. WALD WASSER	MITTEILUNGEN DES ARBEITSKREISES WALD UND WASSER
MITT. BAD. LANDESVER. NAT.KD. NAT.SCHUTZ	MITTEILUNGEN DES BADISCHEN LANDESVEREINS FÜR NATURKUNDE UND NATURSCHUTZ
MITT. EIDGENÖSS. INST. SCHNEE- LAWINENFORSCH.	MITTEILUNGEN DES EIDG. INSTITUTES FÜR SCHNEE- UND LAWINENFORSCHUNG
MITT. HIST. VER. KANTON SCHWYZ	MITTEILUNGEN DES HISTORISCHEN VEREINS DES KANTONS SCHWYZ
MITT. KURAT. WALDARB. FORSTTECH.	MITTEILUNGEN DES KURATORIUMS FÜR WALDARBEIT UND FORSTTECHNIK
MITT. VER. FORSTL. STANDORTSKD. FORSTPFLANZENZÜCHT.	MITTEILUNGEN DES VEREINS FÜR FORSTLICHE STANDORTSKUNDE UND FORSTPFLANZENZÜCHTUNG
MITT. EIDGENÖSS. ANST. FORSTL. VERS.WES.	MITTEILUNGEN EIDG. ANSTALT FÜR DAS FORSTLICHE VERSUCHSWESEN
MITT. FISCH.	MITTEILUNG ZUR FISCHEREI
MOL. ECOL. NOTES	MOLECULAR ECOLOGY NOTES
MOL. ECOL.	MOLECULAR ECOLOGY
MOL. ECOL. RESOUR.	MOLECULAR ECOLOGY RESOURCES
MOL. GENET. GENOMICS	MOLECULAR GENETICS AND GENOMICS
MOL. PHYLOGENET. EVOL.	MOLECULAR PHYLOGENETICS AND EVOLUTION
MOL. PLANT-MICROBE INTERACT.	MOLECULAR PLANT-MICROBE INTERACTIONS
MOL. SCREEN. NEWS	MOLECULAR SCREENING NEWS
MOL. SIMUL.	MOLECULAR SIMULATION
MON.SCHR. WÜRTT. FORSTWES.	MONATSSCHRIFT FÜR DAS WÜRTTEMBERGISCHE FORSTWESEN
MON.SCHR. MECKLENBG.	MONATSSCHRIFT VON UND FÜR MECKLENBURG
MONTAGNA	MONTAGNA
MON. WEATHER REV.	MONTHLY WEATHER REVIEW
MONTI BOSCHI	MONTI E BOSCHI
MT. RES. DEV.	MOUNTAIN RESEARCH AND DEVELOPMENT
MT. RES. INITIAT. NEWSL.	MOUNTAIN RESEARCH INITIATIVE NEWSLETTER
MOV. ECOL.	MOVEMENT ECOLOGY
MYCOKEYS	MYCOKEYS
MYCOL. BALC.	MYCOLOGIA BALCANICA
MYCOL. HELV.	MYCOLOGIA HELVETICA
MYCOLOGIA	MYCOLOGIA
MYCOL. PROG.	MYCOLOGICAL PROGRESS
MYCOL. RES.	MYCOLOGICAL RESEARCH
MYCORRHIZA	MYCORRHIZA
MYCOTAXON	MYCOTAXON
MYRMECOL. NEWS	MYRMECOLOGICAL NEWS
MYRMEKOL. NACHR.	MYRMEKOLOGISCHE NACHRICHTEN
NACHR.BL. BAYER. ENTOMOL.	NACHRICHTENBLATT DER BAYERISCHEN ENTOMOLOGEN
NACHR.BL. DTSCH. PFLANZENSCHUTZD.	NACHRICHTENBLATT DES DEUTSCHEN PFLANZENSCHUTZDIENSTES
NACHR. GFÖ	NACHRICHTEN DER GFÖ
NAT. GEOGR. MAG.	NATIONAL GEOGRAPHIC MAGAZINE
NATL.PARK-FORSCH. SCHWEIZ	NATIONALPARK-FORSCHUNG IN DER SCHWEIZ
NAT. AREAS J.	NATURAL AREAS JOURNAL
NAT. HAZARDS EARTH SYST. SCI.	NATURAL HAZARDS AND EARTH SYSTEM SCIENCES
NAT. HAZARDS	NATURAL HAZARDS
NAT. HIST.	NATURAL HISTORY
NATURALISTA VALTELLINESE	NATURALISTA VALTELLINESE
NAT. CAN.	NATURALISTE CANADIEN
NAT. BELG.	NATURALISTES BELGES
NATURALIST	NATURALIST
NAT. RESOUR. MODEL.	NATURAL RESOURCE MODELING
NAT. RESOUR.	NATURAL RESOURCES
NAT. CULT.	NATURE AND CULTURE
NAT. ENVIRON.	NATURE AND ENVIRONMENT
NAT. LIFE SOUTHEAST ASIA	NATURE AND LIFE IN SOUTHEAST ASIA
NAT. RESOURCES	NATURE AND RESOURCES
NAT. BIOTECHNOL.	NATURE BIOTECHNOLOGY
NAT. CLIM. CHANG.	NATURE CLIMATE CHANGE
NAT. COMMUN.	NATURE COMMUNICATIONS
NAT. PROG.	NATURE ET PROGRÈS
NAT. GENET.	NATURE GENETICS
NAT. GEOSCI.	NATURE GEOSCIENCE
NAT. INF.	NATURE INFORMATION
NAT. PLANTS	NATURE PLANTS
NATURE	NATURE
NAT.KDL. FORSCH. FÜRST. LIECHT.	NATURKUNDLICHE FORSCHUNG IM FÜRSTENTUM LIECHTENSTEIN
NATUROPA	NATUROPA
NATURSCHUTZFORUM	NATURSCHUTZFORUM
NAT.SCHUTZ HEUTE	NATURSCHUTZ HEUTE
NAT.SCHUTZ KÄRNTEN	NATURSCHUTZ IN KÄRNTEN
NAT.SCHUTZ SACHSEN-ANHALT	NATURSCHUTZ IN SACHSEN-ANHALT
NAT.SCHUTZ LANDSCH.PFL. BRANDENBURG	NATURSCHUTZ UND LANDSCHAFTSPFLEGE IN BRANDENBURG
NAT.SCHUTZ LANDSCH.PFL. HAMBG.	NATURSCHUTZ UND LANDSCHAFTSPFLEGE IN HAMBURG
NAT.SCHUTZ LANDSCH.PFL. NIEDERSACHS.	NATURSCHUTZ UND LANDSCHAFTSPFLEGE IN NIEDERSACHSEN
NAT.SCHUTZ LANDSCH.PLAN.	NATURSCHUTZ UND LANDSCHAFTSPLANUNG
NAT. HEIM.	NATUR UND HEIMAT
NAT. LANDSCH.	NATUR UND LANDSCHAFT
NAT.- LANDSCH.SCHUTZGEB. BADEN-WÜRTT.	NATUR- UND LANDSCHAFTSSCHUTZGEBIETE BADEN-WÜRTTEMBERGS
NAT. MENSCH	NATUR UND MENSCH
NAT. MUS.	NATUR UND MUSEUM
NAT. NAT.SCHUTZ MECKLENBG.	NATUR UND NATURSCHUTZ IN MECKLENBURG
NAT. NAT.SCHUTZ MECKLENBG.-VORPOMMERN	NATUR UND NATURSCHUTZ IN MECKLENBURG-VORPOMMERN
NAT. TECH.	NATUR UND TECHNIK
NATURWISSENSCHAFTEN	NATURWISSENSCHAFTEN
NAT.WISS. RUNDSCH.	NATURWISSENSCHAFTLICHE RUNDSCHAU
NEAR SURF. GEOPHYS.	NEAR SURFACE GEOPHYSICS
NED. BOSB.-TIJDSCHR.	NEDERLANDS BOSBOUW-TIJDSCHRIFT
NEMATOL. MEDITERR.	NEMATOLOGIA MEDITERRANEA
NEOTROP. ENTOMOL.	NEOTROPICAL ENTOMOLOGY
NETH. J. AGRIC. SCI.	NETHERLANDS JOURNAL OF AGRICULTURAL SCIENCE
NETH. J. ZOOL.	NETHERLANDS JOURNAL OF ZOOLOGY
NEUE GES. FRANKF. HEFTE	NEUE GESELLSCHAFT FRANKFURTER HEFTE
NEUE LANDSCH.	NEUE LANDSCHAFT
N. ARCH. NIEDERSACHS.	NEUES ARCHIV FÜR NIEDERSACHSEN
NEUE ZÜR. ZTG.	NEUE ZÜRCHER ZEITUNG
NEUJAHRSBL. LESEGES. WÄDENSWIL	NEUJAHRSBLATT DER LESEGESELLSCHAFT WÄDENSWIL
NEUJAHRSBL. NAT.FORSCH. GES. ZÜR.	NEUJAHRSBLATT DER NATURFORSCHENDEN GESELLSCHAFT IN ZÜRICH
NEUJAHRSBL. NAT.FORSCH. GES. SCHAFFHAUSEN	NEUJAHRSBLATT DER NATURFORSCHENDEN GESELLSCHAFT SCHAFFHAUSEN
NEUJAHRSBOTE GLARNER HINTERLAND	NEUJAHRSBOTE FÜR DAS GLARNER HINTERLAND
NEUROSCIENCE	NEUROSCIENCE
NEW FOR.	NEW FORESTS
NEW PHYTOL.	NEW PHYTOLOGIST
NEW SCI.	NEW SCIENTIST
NEWSL. E-GEO.CH	NEWSLETTER E-GEO.CH
NEWS FOR. HIST.	NEWS OF FOREST HISTORY
N. Z. J. BOT.	NEW ZEALAND JOURNAL OF BOTANY
N. Z. J. ECOL.	NEW ZEALAND JOURNAL OF ECOLOGY
N. Z. J. FOR. SCI.	NEW ZEALAND JOURNAL OF FORESTRY SCIENCE
N. Z. J. ZOOL.	NEW ZEALAND JOURNAL OF ZOOLOGY
N. Z. PLANT PROT.	NEW ZEALAND PLANT PROTECTION
NIEDERSÄCHS. AKAD. GEOWISS. VERÖFF.	NIEDERSÄCHSISCHE AKADEMIE DER GEOWISSENSCHAFTEN VERÖFFENTLICHUNGEN
NNA-BER.	NNA-BERICHTE
NONLINEAR PROCESS. GEOPHYS.	NONLINEAR PROCESSES IN GEOPHYSICS
NORD. HYDROL.	NORDIC HYDROLOGY
NORD. J. BOT.	NORDIC JOURNAL OF BOTANY
NORTH AM. J. FISH. MANAGE.	NORTH AMERICAN JOURNAL OF FISHERIES MANAGEMENT
NORTHWEST SCI.	NORTHWEST SCIENCE
NOR. J. GEOGR.	NORWEGIAN JOURNAL OF GEOGRAPHY
NOS OISEAUX	NOS OISEAUX
NOSTRO PAESE	NOSTRO PAESE
NOTA LEPIDOPTEROL.	NOTA LEPIDOPTEROLOGICA
NOTES TECH. CENT. ÉCOL. FOR. RURAL	NOTES TECHNIQUES DU CENTRE DÉCOLOGIE FORESTIÈRE ET RURALE
NOTE TECH. GROUP. TECH. FOR.	NOTE TECHNIQUE GROUPEMENT TECHNIQUE FORESTIER
NOT. PRAT. (FRZ.)	NOTICE POUR LE PRATICIEN
NOT. PRAT. (ITAL.)	NOTIZIE PER LA PRATICA
NOT. BOT. HORTI AGROBOT. CLUJ-NAPOCA	NOTULAE BOTANICAE HORTI AGROBOTANICI CLUJ-NAPOCA
NOT. ODONATOLOGICAE	NOTULAE ODONATOLOGICAE
NOUV. LANDESHYDROL. -GEOL.	NOUVELLES DER LANDESHYDROLOGIE UND -GEOLOGIE
NOVA HEDWIGIA	NOVA HEDWIGIA
NUCL. INSTRUM. METHODS PHYS. RES.	NUCLEAR INSTRUMENTS AND METHODS IN PHYSICS RESEARCH
NUCLEIC ACIDS RES.	NUCLEIC ACIDS RESEARCH
NUOVO G. BOT. ITAL.	NUOVO GIORNALE BOTANICO ITALIANO
NUTRI. CYCL. AGROECOSYST.	NUTRIENT CYCLING IN AGROECOSYSTEMS
NUTZHOLZVERBRAUCH SCHWEIZ	NUTZHOLZVERBRAUCH IN DER SCHWEIZ
OCEAN COAST. MANAGE.	OCEAN AND COASTAL MANAGEMENT
OCEANUS	OCEANUS
OECOLOGIA	OECOLOGIA
OEKOL. PLANT.	OEKOLOGIA PLANTARUM
OEKOL. VÖGEL	OEKOLOGIE DER VÖGEL
OESTERR. WASSER- ABFALLWIRTSCH.	OESTERREICHISCHE WASSER- UND ABFALLWIRTSCHAFT
OIKOS	OIKOS
ÖKOL. LANDBAU	ÖKOLOGIE UND LANDBAU
ÖKOL. WIRTSCH.	ÖKOLOGISCHES WIRTSCHAFTEN
ONLINE, ADL-NACHR.	ONLINE, ADL-NACHRICHTEN
OPEN FOR. SCI. J.	OPEN FOREST SCIENCE JOURNAL
OPERA BOT.	OPERA BOTANICA
OPT. EXPRESS	OPTICS EXPRESS
ORG. GEOCHEM.	ORGANIC GEOCHEMISTRY
ORGANISATOR	ORGANISATOR
ORGAN. BEHAV. HUM. DECIS. PROCESS.	ORGANIZATIONAL BEHAVIOUR AND HUMAN DECISION PROCESSES
ORGAN. RES. METHODS	ORGANIZATIONAL RESEARCH METHODS
ORGANOHALOG. COMPD.	ORGANOHALOGEN COMPOUNDS
ORNIS FENN.	ORNIS FENNICA
ORNIS SCAND.	ORNIS SCANDINAVICA
ORNITHOL. ABH.	ORNITHOLOGISCHE ABHANDLUNGEN
ORNITHOL. BEOB.	ORNITHOLOGISCHE BEOBACHTER
ORNITHOL. JAHRESH. BADEN-WÜRTT.	ORNITHOLOGISCHE JAHRESHEFTE FÜR BADEN-WÜRTTEMBERG
ORNITHOL. MITT.	ORNITHOLOGISCHE MITTEILUNGEN
ORNITHOL. MON.BER.	ORNITHOLOGISCHE MONATSBERICHTE
ORNITHOL. ANZ.	ORNITHOLOGISCHER ANZEIGER
ORNITHOL. RD.BR. MECKLENBG.-VORPOMMERN	ORNITHOLOGISCHER RUNDBRIEF FÜR MECKLENBURG-VORPOMMERN
ÖSTERR. BOT. Z.	ÖSTERREICHISCHE BOTANISCHE ZEITSCHRIFT
ÖSTERR. FORSTZTG.	ÖSTERREICHISCHE FORSTZEITUNG
ÖSTERR. ING. ARCHIT.-Z.	ÖSTERREICHISCHE INGENIEUR- UND ARCHITEKTEN-ZEITSCHRIFT
PAC. SCI.	PACIFIC SCIENCE
PAGES NEWS	PAGES NEWS
PALAEOGEOGR. PALAEOCLIMATOL. PALAEOECOL.	PALAEOGEOGRAPHY PALAEOCLIMATOLOGY PALAEOECOLOGY
PALAEONTOL. ELECTRON.	PALAEONTOLOGIA ELECTRONICA
PALÄOKLIMAFORSCHUNG	PALÄOKLIMAFORSCHUNG
PALEOCLIM. RES.	PALEOCLIMATE RESEARCH
PAP. LAB. TREE RING RES.	PAPERS OF THE LABORATORY OF TREE RING RESEARCH
PAP. MICH. ACAD. SCI. ARTS LETT.	PAPERS OF THE MICHIGAN ACADEMY OF SCIENCE, ARTS AND LETTERS
PATTERN RECOGNIT.	PATTERN RECOGNITION
PBMD-BULL.	PBMD-BULLETIN
PEATLANDS INT.	PEATLANDS INTERNATIONAL
PEDOSPHERE	PEDOSPHERE
PEERJ	PEERJ
PERCEPT. PSYCHOPHYS.	PERCEPTION AND PSYCHOPHYSICS
PERMAFROST PERIGLACIAL PROCESS.	PERMAFROST AND PERIGLACIAL PROCESSES
PERS. UBIQUIT. COMPUT.	PERSONAL AND UBIQUITOUS COMPUTING
PERS. INDIVID. DIFFER.	PERSONALITY AND INDIVIDUAL DIFFERENCES
PERSPECT. PLANT ECOL. EVOL. SYST.	PERSPECTIVES IN PLANT ECOLOGY, EVOLUTION AND SYSTEMATICS
PFLANZENSCHUTZ-NACHR. BAYER	PFLANZENSCHUTZ-NACHRICHTEN BAYER
PHILOS. TRANS. R. SOC. B	PHILOSOPHICAL TRANSACTIONS OF THE ROYAL SOCIETY B
PHILOS. TRANS. R. SOC. LOND.	PHILOSOPHICAL TRANSACTIONS OF THE ROYAL SOCIETY OF LONDON
PHOTOCHEM. PHOTOBIOL.	PHOTOCHEMISTRY AND PHOTOBIOLOGY
PHOTOGRAMM. ENG. REMOTE SENS.	PHOTOGRAMMETRIC ENGINEERING AND REMOTE SENSING
PHOTOGRAMM. REC.	PHOTOGRAMMETRIC RECORD
PHOTOGRAMM. FERNERKUND. GEOINF.	PHOTOGRAMMETRIE, FERNERKUNDUNG, GEOINFORMATION
PHOTOSYNTHETICA	PHOTOSYNTHETICA
PHYS. GEOGR.	PHYSICAL GEOGRAPHY
PHYS. REV. E	PHYSICAL REVIEW E
PHYS. REV. LETT.	PHYSICAL REVIEW LETTERS
PHYS. CHEM. EARTH	PHYSICS AND CHEMISTRY OF THE EARTH
PHYS. LETT. A	PHYSICS LETTERS A
PHYS. FLUIDS	PHYSICS OF FLUIDS
PHYS. WORLD	PHYSICS WORLD
PHYS. BL.	PHYSIKALISCHE BLÄTTER
PHYS. UNSERER ZEIT	PHYSIK IN UNSERER ZEIT
PHYSIOL. PLANT.	PHYSIOLOGIA PLANTARUM
PHYSIOL. MOL. PLANT PATHOL.	PHYSIOLOGICAL AND MOLECULAR PLANT PATHOLOGY
PHYSIOL. ENTOMOL.	PHYSIOLOGICAL ENTOMOLOGY
PHYSIOL. PLANT PATHOL.	PHYSIOLOGICAL PLANT PATHOLOGY
PHYS. GEOGR.	PHYSISCHE GEOGRAPHIE
PHYTOCHEMISTRY	PHYTOCHEMISTRY
PHYTOCOENOLOGIA	PHYTOCOENOLOGIA
PHYTON	PHYTON
PHYTOPATHOL. Z.	PHYTOPATHOLOGISCHE ZEITSCHRIFT
PHYTOPATHOLOGY	PHYTOPATHOLOGY
PLAN	PLAN
PLAN. DES.	PLANNING AND DESIGN
PLANT CELL PHYSIOL.	PLANT AND CELL PHYSIOLOGY
PLANT SOIL	PLANT AND SOIL
PLANTA	PLANTA
PLANT BIOL.	PLANT BIOLOGY
PLANT BIOSYST.	PLANT BIOSYSTEMS
PLANT CELL ENVIRON.	PLANT, CELL AND ENVIRONMENT
PLANT DIS.	PLANT DISEASE
PLANT ECOL.	PLANT ECOLOGY
PLANT ECOL. DIVERS.	PLANT ECOLOGY AND DIVERSITY
PLANT J.	PLANT JOURNAL
PLANT MOL. BIOL. REPORT.	PLANT MOLECULAR BIOLOGY REPORTER
PLANT PHYSIOL. BIOCHEM.	PLANT PHYSIOLOGY AND BIOCHEMISTRY
PLANT PHYSIOL.	PLANT PHYSIOLOGY
PLANT SPECIES BIOL.	PLANT SPECIES BIOLOGY
PLANT SYST. EVOL.	PLANT SYSTEMATICS AND EVOLUTION
PLEIONE	PLEIONE
PLOS ONE	PLOS ONE
PLOS PATHOG.	PLOS PATHOGENES
POLAR BIOL.	POLAR BIOLOGY
POLAR RES.	POLAR RESEARCH
POLICY SCI.	POLICY SCIENCES
POL. BOT. STUD.	POLISH BOTANICAL STUDIES
POL. ECOL. STUD.	POLISH ECOLOGICAL STUDIES
POL. J. ECOL.	POLISH JOURNAL OF ECOLOGY
POL. J. ENVIRON. STUD.	POLISH JOURNAL OF ENVIRONMENTAL STUDIES
POLIT. PSYCHOL.	POLITICAL PSYCHALOGY
POLIT. SCI. POLIT.	POLITICAL SCIENCE AND POLITICS
POLIT. ÖKOL.	POLITISCHE ÖKOLOGIE
POLLEN SPORES	POLLEN ET SPORES
POPUL. ENVIRON.	POPULATION AND ENVIRONMENT
POPUL. ECOL.	POPULATION ECOLOGY
PRAKT. FORSTWIRT SCHWEIZ	PRAKTISCHE FORSTWIRT FÜR DIE SCHWEIZ
PROCEDIA ENG.	PROCEDIA ENGINEERING
PROCEDIA SOC. BEHAV. SCI.	PROCEDIA SOCIAL AND BEHAVIORAL SCIENCES
PROC. INT. CONGR. ECOL.	PROCEEDINGS OF THE INTERNATIONAL CONGRESS OF ECOLOGY
PROC. INT. SYMP. BOREAL FOR.	PROCEEDINGS OF THE INTERNATIONAL SYMPOSIUM ON BOREAL FOREST
PROC. LINN. SOC. N. S. W.	PROCEEDINGS OF THE LINNEAN SOCIETY OF NEW SOUTH WALES
PROC. NATL. ACAD. SCI. U.S.A.	PROCEEDINGS OF THE NATIONAL ACADEMY OF SCIENCE OF THE UNITED STATES OF AMERICA
PROC. R. IR. ACAD.	PROCEEDINGS OF THE ROYAL IRISH ACADEMY
PROC. R. SOC. LOND.	PROCEEDINGS OF THE ROYAL SOCIETY OF LONDON
PROC. SOIL SCI. SOC. AM.	PROCEEDINGS OF THE SOIL SCIENCE SOCIETY OF AMERICA
PROC. ZOOL. SOC. LOND.	PROCEEDINGS OF THE ZOOLOGICAL SOCIETY OF LONDON
PROF. GEOGR.	PROFESSIONAL GEOGRAPHER
PROG. BIOMETEOROL.	PROGRESS IN BIOMETEOROLOGY
PROG. BOT.	PROGRESS IN BOTANY
PROG. HUM. GEOGR.	PROGRESS IN HUMAN GEOGRAPHY
PROG. PHYS. GEOGR.	PROGRESS IN PHYSICAL GEOGRAPHY
PROGRESS. REI BOT.	PROGRESSUS REI BOTANICAE
PROT. NAT.	PROTECTION DE LA NATURE
PROTIST	PROTIST
PSYCHE	PSYCHE
PSYCHOL. BULL.	PSYCHOLOGICAL BULLETIN
PSYCHOL. HEALTH	PSYCHOLOGY AND HEALTH
PUBBL. CENT. SPER. AGRIC. FOR.	PUBBLICAZIONI DEL CENTRO DI SPERIMENTAZIONE AGRICOLA E FORESTALE
PUBLIC HEALTH FORUM	PUBLIC HEALTH FORUM
PUBLIC HIST. REV.	PUBLIC HISTORY REVIEW
PUBLIC OPIN. Q.	PUBLIC OPINION QUARTERLY
PUBL. DTSCH. GES. PHOTOGRAMM. FERNERKUND. GEOINF.	PUBLIKATIONEN DER DEUTSCHEN GESELLSCHAFT FÜR PHOTOGRAMMETRIE, FERNERKUNDUNG UND GEOINFORMATIONEN
Q. BULL. INT. ASSOC. AGRIC. INF. SPEC.	QUARTERLY BULLETIN OF THE INTERNATIONAL ASSOCIATION OF AGRICULTURAL INFORMATION SPECIALISTS
Q. J. ENG. GEOL. HYDROGEOL.	QUARTERLY JOURNAL OF ENGINEERING GEOLOGY AND HYDROGEOLOGY
Q. J. FOR.	QUARTERLY JOURNAL OF FORESTRY
Q. J. R. METEOROL. SOC.	QUARTERLY JOURNAL OF THE ROYAL METEEOROLOGICAL SOCIETY
Q. REV. BIOL.	QUARTERLY REVIEW OF BIOLOGY
QUAT.	QUATERNAIRE
QUAT. INT.	QUATERNARY INTERNATIONAL
QUAT. RES.	QUATERNARY RESEARCH
QUAT. SCI. REV.	QUATERNARY SCIENCE REVIEWS
RADIAT. PROT. DOSIMETR.	RADIATION PROTECTION DOSIMETRY
RADIOCARBON	RADIOCARBON
RADIOCHIM. ACTA	RADIOCHIMICA ACTA
RANGELAND ECOL. MANAGE.	RANGELAND ECOLOGY AND MANAGEMENT
RAPID COMMUN. MASS SPECTROM.	RAPID COMMUNICATIONS IN MASS SPECTROMETRY
RAUMFORSCH. RAUMORDN.	RAUMFORSCHUNG UND RAUMORDNUNG
RAUMPLAN., INF.H.	RAUMPLANUNG, INFORMATIONSHEFTE
RECHERCHE	RECHERCHE
RECH. AGRON. SUISSE	RECHERCHE AGRONOMIQUE SUISSE
REFA-NACHR.	REFA-NACHRICHTEN
REG. BASIL.	REGIO BASILIENSIS
REG. ENVIRON. CHANG.	REGIONAL ENVIRONMENTAL CHANGE
REG. STUD.	REGIONAL STUDIES
RELIAB. ENG. SYST. SAF.	RELIABILITY ENGINEERING AND SYSTEM SAFETY
REMOTE SENS. LETT.	REMOTE SENSING LETTERS
REMOTE SENS. ENVIRON.	REMOTE SENSING OF ENVIRONMENT
REMOTE SENS.	REMOTE SENSING
REMOTE SENS. SER.	REMOTE SENSING SERIES
RENEW. ENERGY	RENEWABLE ENERGY
RENEW. SUSTAINABLE ENERGY REV.	RENEWABLE & SUSTAINABLE ENERGY REVIEWS
REP. KEVO SUBARCT. RES. STN.	REPORTS FROM THE KEVO SUBARCTIC RESEARCH STATION
RES. BULL. COLL. EXP. FOR., HOKKAIDO UNIV.	RESEARCH BULLETINS OF THE COLLEGE EXPERIMENT FORESTS, HOKKAIDO UNIVERSITY
RES. POPUL. ECOL.	RESEARCHES ON POPULATION ECOLOGY
RES. ECON. ANTHROPOL.	RESEARCH IN ECONOMIC ANTHROPOLOGY
RES. LIFE SCI.	RESEARCH IN LIFE SCIENCES
RES. MICROBIOL.	RESEARCH IN MICROBIOLOGY
RES. PAP. USDA FOR. SERV.	RESEARCH PAPER USDA FOREST SERVICE
RESOUR. ENERGY ECON.	RESOURCE AND ENERGY ECONOMICS
RESTOR. ECOL.	RESTORATION ECOLOGY
REV. ECON.	REVIEW OF ECONOMICS
REV. PALAEOBOT. PALYNOL.	REVIEW OF PALAEOBOTANY AND PALYNOLOGY
REV. PLANT PATHOL.	REVIEW OF PLANT PATHOLOGY
REV. GEOPHYS.	REVIEWS OF GEOPHYSICS
REV. CHIL. HIST. NAT.	REVISTA CHILENA DE HISTORIA NATURAL
REV. BIOL. TROP.	REVISTA DE BIOLOGIA TROPICAL
REV. TELEDETECCION	REVISTA DE TELEDETECCION
REV. PERU. GEO-ATMOS.	REVISTA PERUANA GEO-ATMOSFERICA
REV. BRYOL. LICHÉNOL.	REVUE BRYOLOGIQUE ET LICHÉNOLOGIQUE
REV. CAN. RECH. FOR.	REVUE CANADIENNE DE RECHERCHE FORESTIÈRE
REV. ARCHÉOM.	REVUE D'ARCHÉOMETRIE
REV. GEOGR. ALP.	REVUE DE GÉOGRAPHIE ALPINE
REV. RECH. SERV. CAN. FOR.	REVUE DE RECHERCHES DU SERVICE CANADIEN DES FORÊTS
REV. EAUX FOR.	REVUE DES EAUX ET FORÊTS
REV. BOIS APPL.	REVUE DU BOIS ET DE SES APPLICATIONS
REV. FOR. FR.	REVUE FORESTIÈRE FRANÇAISE
REV. GEN. BOT.	REVUE GÉNÉRALE DE BOTANIQUE
REV. MENS. MUS. COLLECT. VILLE GENÈVE	REVUE MENSUELLE DES MUSÉES ET COLLECTIONS DE LA VILLE GENÈVE
REV. SUISSE AGRIC.	REVUE SUISSE D'AGRICULTURE
REV. SUISSE VITIC. ARBORIC. HORTIC.	REVUE SUISSE DE VITICULTURE ARBORICULTURE HORTICULTURE
REV. SUISSE ZOOL.	REVUE SUISSE DE ZOOLOGIE
REV. SUISSE HYDROL.	REVUE SUISSE D'HYDROLOGIE
RISK ANAL.	RISK ANALYSIS
RIVER RES. APPL.	RIVER RESEARCH AND APPLICATIONS
RIV. ITAL. TELERILEVAMENTO	RIVISTA ITALIANA DI TELERILEVAMENTO
ROCKY MT. FOR. RANGE EXP. STN., FOR. SER.	ROCKY MOUNTAIN FOREST AND RANGE EXPERIMENT STATION, FOREST SERIES
RUNDGESPR. KOMM. ÖKOL.	RUNDGESPRÄCHE DER KOMMISSION FÜR ÖKOLOGIE
RUSS. J. ECOL.	RUSSIAN JOURNAL OF ECOLOGY
SAH BULL.	SAH BULLETIN
SALAMANDRA	SALAMANDRA
SÄUGETIERKD. MITT.	SÄUGETIERKUNDLICHE MITTEILUNGEN
SAUSSUREA	SAUSSUREA
SAUTERIA	SAUTERIA
SCAND. HOUS. PLAN. RES.	SCANDINAVIAN HOUSING AND PLANNING RESEARCH
SCAND. J. FOR. RES.	SCANDINAVIAN JOURNAL OF FOREST RESEARCH
SCAND. J. HOSP. TOUR.	SCANDINAVIAN JOURNAL OF HOSPITALITY AND TOURISM
SCAND J. MED. SCI. SPORTS	SCANDINAVIAN JOURNAL OF MEDICINE AND SCIENCE IN SPORTS
SCAND. J. PSYCHOL.	SCANDINAVIAN JOURNAL OF PSYCHOLOGY
SCAND. J. STAT.	SCANDINAVIAN JOURNAL OF STATISTICS
SCHR. FORSTL. FAK. UNIV. GÖTT. NIEDERSÄCHS. FORSTL. VERS.ANST.	SCHRIFTEN AUS DER FORSTLICHEN FAKULTÄT DER UNIVERSITÄT GÖTTINGEN UND DER NIEDERSÄCHSISCHEN FORSTLICHEN VERSUCHSANSTALT
SCHR.REIHE BAYER. LANDESAMT UMWELTSCHUTZ	SCHRIFTENREIHE BAYERISCHES LANDESAMT FÜR UMWELTSCHUTZ
SCHR.REIHE BAD. FORSTL. VERS.ANST., FREIBG.	SCHRIFTENREIHE DER BADISCHEN FORSTLICHEN VERSUCHSANSTALT FREIBURG
SCHR.REIHE FORSTWISS. FAK. ALBERT-LUDWIGS-UNIV. FREIBG. I.B.	SCHRIFTENREIHE DER FORSTWISSENSCHAFTLICHEN FAKULTÄT DER ALBERT-LUDWIGS-UNIVERSITÄT FREIBURG I. BR.
SCHR.REIHE LANDESANST. ÖKOL. LANDSCH.ENTWICKL. FORSTPLAN. NORDRH.-WESTFAL.	SCHRIFTENREIHE DER LANDESANSTALT FÜR ÖKOLOGIE, LANDSCHAFTSENTWICKLUNG UND FORSTPLANUNG NORDRHEIN-WESTFALEN
SCHR.REIHE LANDESFORSTVERWALT. BADEN-WÜRTT.	SCHRIFTENREIHE DER LANDESFORSTVERWALTUNG BADEN-WÜRTTEMBERG
SCHR.REIHE LANDESSTELLE NAT.SCHUTZ LANDSCH.PFL. NORDRH.-WESTFAL.	SCHRIFTENREIHE DER LANDESSTELLE FÜR NATURSCHUTZ UND LANDSCHAFTSPFLEGE IN NORDRHEIN-WESTFALEN
SCHR.REIHE AMT UMWELTSCHUTZ	SCHRIFTENREIHE DES AMTES FÜR UMWELTSCHUTZ
SCHR.REIHE BAYER. STAATSMINIST. ERNÄHR. LANDWIRTSCH. FORSTEN	SCHRIFTENREIHE DES BAYERISCHEN STAATSMINISTERIUMS FÜR ERNÄHRUNG, LANDWIRTSCHAFT UND FORSTEN
SCHR.REIHE DTSCH. RAT LANDESPFL.	SCHRIFTENREIHE DES DEUTSCHEN RATES FÜR LANDESPFLEGE
SCHR.REIHE INST. LANDESPFL. UNIV. FREIBG.	SCHRIFTENREIHE DES INSTITUTES FÜR LANDESPFLEGE DER UNIVERSITÄT FREIBURG
SCHR.REIHE LANDSCH.PFL. NAT.SCHUTZ	SCHRIFTENREIHE FÜR LANDSCHAFTSPFLEGE UND NATURSCHUTZ
SCHR.REIHE VEG.KD.	SCHRIFTENREIHE FÜR VEGETATIONSKUNDE
SCHR.REIHE LEBENSRAUM VORARLBERG	SCHRIFTENREIHE LEBENSRAUM VORARLBERG
SCHR.REIHE UMW.	SCHRIFTENREIHE UMWELT
SCHR. FORST- UMWELTÖKON.	SCHRIFTEN ZUR FORST- UND UMWELTÖKONOMIE
SCHWEIZ. ARCH. TIERHEILKD.	SCHWEIZER ARCHIV DER TIERHEILKUNDE
SCHWEIZ. FÖRSTER	SCHWEIZER FÖRSTER
SCHWEIZ. HOLZ-BÖRSE	SCHWEIZER HOLZ-BÖRSE
SCHWEIZ. HOLZ-REV.	SCHWEIZER HOLZ-REVUE
SCHWEIZ. HOLZWIRTSCH.	SCHWEIZER HOLZWIRTSCHAFT
SCHWEIZ. HOLZZTG.	SCHWEIZER HOLZZEITUNG
SCHWEIZ. ING. ARCHIT.	SCHWEIZER INGENIEUR UND ARCHITEKT
SCHWEIZ. BEITR. DENDROL.	SCHWEIZERISCHE BEITRÄGE ZUR DENDROLOGIE
SCHWEIZ. GES. PHYTOMED., INFO	SCHWEIZERISCHE GESELLSCHAFT FÜR PHYTOMEDIZIN, INFO
SCHWEIZ. INTERESSENGEM. IND.HOLZ, ANLEIT.	SCHWEIZERISCHE INTERESSENGEMEINSCHAFT INDUSTRIEHOLZ, ANLEITUNG
SCHWEIZ. LANDWIRTSCH. FORSCH.	SCHWEIZERISCHE LANDWIRTSCHAFTLICHE FORSCHUNG
SCHWEIZ. STÄDTEVERB. FOCUS	SCHWEIZERISCHER STÄDTEVERBAND, FOCUS
SCHWEIZ. ARCH. VOLKSKD.	SCHWEIZERISCHES ARCHIV FÜR VOLKSKUNDE
SCHWEIZ. SCHREINERZTG.	SCHWEIZERISCHE SCHREINERZEITUNG
SCHWEIZ. Z. FORSTWES.	SCHWEIZERISCHE ZEITSCHRIFT FÜR FORSTWESEN
SCHWEIZ. Z. HYDROL.	SCHWEIZERISCHE ZEITSCHRIFT FÜR HYDROLOGIE
SCHWEIZ. Z. PILZKD.	SCHWEIZERISCHE ZEITSCHRIFT FÜR PILZKUNDE
SCHWEIZ. Z. VOLKSWIRTSCH. STAT.	SCHWEIZERISCHE ZEITSCHRIFT FÜR VOLKSWIRTSCHAFT UND STATISTIK
SCHWEIZ. JÄGER	SCHWEIZER JÄGER
SCHWEIZ. LANDTECH.	SCHWEIZER LANDTECHNIK
SCHWEIZ. NAT.SCHUTZ	SCHWEIZER NATURSCHUTZ
SCHWEIZ. WALD	SCHWEIZER WALD
SCI. SOL	SCIENCE DU SOL
SCI. TOTAL ENVIRON.	SCIENCE OF THE TOTAL ENVIRONMENT
SCIENCE	SCIENCE
SCI. TECHNOL. SOC.	SCIENCE, TECHNOLOGY AND SOCIETY
SCI. HORTIC.	SCIENTIA HORTICULTURAE
SCI. AM.	SCIENTIFIC AMERICAN
SCI. REP.	SCIENTIFIC REPORTS
SCIENZE	SCIENZE
SCOTT. FOR.	SCOTTISH FORESTRY
SCR. GEOBOT.	SCRIPTA GEOBOTANICA
SCR. HORTIC.	SCRIPTA HORTICULTURAE
SCR. MATER.	SCRIPTA MATERIALIA
SENSORS	SENSORS
SERV. RECH. TERRES FOR., QUÉ.	SERVICE DE LA RECHERCHE TERRES ET FORÊTS, QUÉBEC
SGU-BULL.	SGU-BULLETIN
SHERWOOD	SHERWOOD
SILVAE GENET.	SILVAE GENETICA
SILVA FENN.	SILVA FENNICA
SMALL-SCALE FOR. ECON. MANAGE. POLICY	SMALL-SCALE FOREST ECONOMICS, MANAGEMENT AND POLICY
SOC. ITAL. ECOL., ATTI	SOCIETÀ ITALIANA DI ECOLOGIA, ATTI
SOC. CONTEMP.	SOCIÉTÉS CONTEMPORAINES
SOC. NAT. RESOUR.	SOCIETY AND NATURAL RESOURCES
SOC. EXP. BIOL. SEMIN. SER.	SOCIETY FOR EXPERIMENTAL BIOLOGY SEMINAR SERIES
SOCIOL. RURALIS	SOCIOLOGIA RURALIS
SOCIOL. FORUM	SOCIOLOGICAL FORUM
SOFT MATTER	SOFT MATTER
SOIL TILLAGE RES.	SOIL AND TILLAGE RESEARCH
SOIL BIOL. BIOCHEM.	SOIL BIOLOGY AND BIOCHEMISTRY
SOIL BIOL.	SOIL BIOLOGY
SOILS FOUND.	SOILS AND FOUNDATIONS
SOIL SCI. PLANT NUTR.	SOIL SCIENCE AND PLANT NUTRITION
SOIL SCI.	SOIL SCIENCE
SOIL SCI. SOC. AM. J.	SOIL SCIENCE SOCIETY OF AMERICA JOURNAL
SOLUTIONS J.	SOLUTIONS JOURNAL
S. AFR. J. SCI.	SOUTH AFRICAN JOURNAL OF SCIENCE
SOUTHEAST. GEOGR.	SOUTHEASTERN GEOGRAPHER
SOUTHEAST. GEOL.	SOUTHEASTERN GEOLOGY
SOUTHWEST. NAT.	SOUTHWESTERN NATURALIST
SOV. J. ECOL.	SOVIET JOURNAL OF ECOLOGY
SOZIAL. FORSTWIRTSCH.	SOZIALISTISCHE FORSTWIRTSCHAFT
SPEEDUP	SPEEDUP
SPEKTRUM WISS.	SPEKTRUM DER WISSENSCHAFT
SPORTS ENG.	SPORTS ENGINEERING
STAIN TECHNOL.	STAIN TECHNOLOGY
STAPFIA	STAPFIA
STAT. PAP.	STATISTICAL PAPERS
STAT. JAHRB. SCHWEIZ	STATISTISCHES JAHRBUCH DER SCHWEIZ
STIFT. REUSSTAL, JAHRESBER.	STIFTUNG REUSSTAL, JAHRESBERICHT
STRUCT. CHANG. ECON. DYN.	STRUCTURAL CHANGE AND ECONOMIC DYNAMICS
STRUCT. ENG. INT.	STRUCTURAL ENGINEERING INTERNATIONEL
STUD. FOR. SUEC.	STUDIA FORESTALIA SUECICA
STUD. TROP. ANDEAN ECOSYST.	STUDIES ON TROPICAL ANDEAN ECOSYSTEMS
STUD. TRENTINI SCI. NAT. ACTA BIOL.	STUDI TRENTINI DI SCIENZE NATURALI ACTA BIOLOGICA
STUTTG. BEITR. NAT.KD.	STUTTGARTER BEITRÄGE ZUR NATURKUNDE
SUBST. USE MISUSE	SUBSTANCE USE AND MISUSE
SUSTAINABILITY: SCI. PRACT. POLICY	SUSTAINABILITY: SCIENCE PRACTICE & POLICY
SVEN. BOT. TIDSKR.	SVENSK BOTANISK TIDSKRIFT
SWISS POLIT. SCI. REV.	SWISS POLITICAL SCIENCE REVIEW
SYDOWIA	SYDOWIA
SYMBIOSIS	SYMBIOSIS
SYMB. BOT. UPS.	SYMBOLAE BOTANICAE UPSALIENSES
SYST. BIOL.	SYSTEMATIC BIOLOGY
SYST. ENTOMOL.	SYSTEMATIC ENTOMOLOGY
SYST. RES. BEHAV. SCI.	SYSTEMS RESEARCH AND BEHAVIORAL SCIENCE
TAGES-ANZ. MAG.	TAGES-ANZEIGER MAGAZIN
TAIWAN J. FOR. SCI.	TAIWAN JOURNAL OF FOREST SCIENCE
TALANTA	TALANTA
TANZANIA J. FOR. NAT. CONSERV.	TANZANIA JOURNAL OF FORESTRY AND NATURE CONSERVATION
TÄTIGK.BER. NAT.FORSCH. GES. BASELLAND	TÄTIGKEITSBERICHT DER NATURFORSCHENDEN GESELLSCHAFT BASELLAND
TAXON	TAXON
TECH. REP. FOR. ENG. RES. INST. CAN.	TECHNICAL REPORT FOREST ENGINEERING RESEARCH INSTITUTE OF CANADA
TECH. REP. HYDROL. WATER RESOUR.	TECHNICAL REPORTS IN HYDROLOGY AND WATER RESOURCES
TECH. RUNDSCH.	TECHNISCHE RUNDSCHAU
TECHNOL. REV.	TECHNOLOGY REVIEW
TELLUS SER. B	TELLUS: SERIES B CHEMICAL AND PHYSICAL METEOROLOGY
TELMA	TELMA
TERRE VIE	TERRE ET LA VIE
TERR. INTERJURA.	TERRIEN INTERJURASSIEN
CARTOGR. J.	THE CARTOGRAPHIC JOURNAL
ISME J.	THE ISME JOURNAL
THEOR. APPL. CLIMATOL.	THEORETICAL AND APPLIED CLIMATOLOGY
THEOR. APPL. GENET.	THEORETICAL AND APPLIED GENETICS
THEOR. POPUL. BIOL.	THEORETICAL POPULATION BIOLOGY
THEORY DECIS.	THEORY AND DECISION
THEORY BIOSCI.	THEORY IN BIOSCIENCES
PLANT CELL	THE PLANT CELL
THURG. JAHRB.	THURGAUER JAHRBUCH
TIERÄRZTL. UMSCH.	TIERÄRZTLICHE UMSCHAU
TIMBER BULL. EUR.	TIMBER BULLETIN FOR EUROPE
TOUR. GEOGR.	TOURISM GEOGRAPHIES
TOUR. MANAGE.	TOURISM MANAGEMENT
TOUR. REV.	TOURISM REVIEW
TOXICOL. ENVIRON. CHEM.	TOXICOLOGICAL AND ENVIRONMENTAL CHEMISTRY
TOXINS	TOXINS
TRANS. GIS	TRANSACTIONS IN GIS
TRANS. BR. MYCOL. SOC.	TRANSACTIONS OF THE BRITISH MYCOLOGICAL SOCIETY
TRANS. INST. BR. GEOGR.	TRANSACTIONS OF THE INSTITUTE OF BRITISH GEOGRAPHERS
TRANS. R. SOC. EDINB., EARTH SCI.	TRANSACTIONS OF THE ROYAL SOCIETY OF EDINBURGH, EARTH SCIENCES
TRANSP. RES.	TRANSPORTATION RESEARCH
TRAV. SCI. PARC NATL. VANOISE	TRAVAUX SCIENTIFIQUES DU PARC NATIONAL DE LA VANOISE
TRAV. STN. RECH. EAUX FOR.	TRAVAUX STATION DE RECHERCHES DES EAUX ET FORÊTS
TREE GENET. GENOMES	TREE GENETICS AND GENOMES
TREE PHYSIOL.	TREE PHYSIOLOGY
TREE-RING BULL.	TREE-RING BULLETIN
TREE-RING RES.	TREE-RING RESEARCH
TREES	TREES
TRENDS ECOL. EVOL.	TRENDS IN ECOLOGY AND EVOLUTION
TRENDS PARASITOL.	TRENDS IN PARASITOLOGY
TRENDS PLANT SCI.	TRENDS IN PLANT SCIENCE
TRIBOL. LETT.	TRIBOLOGY LETTERS
TROCHILUS	TROCHILUS
TROP. AGRIC.	TROPICAL AGRICULTURE
TROP. BRYOL.	TROPICAL BRYOLOGY
TÜB. GEOGR. STUD.	TÜBINGER GEOGRAPHISCHE STUDIEN
TUEXENIA	TUEXENIA
UMSCHAU	UMSCHAU
UMSCH. WISS. TECH.	UMSCHAU IN WISSENSCHAFT UND TECHNIK
UMW. AARGAU	UMWELT AARGAU
UMW. AKTUELL	UMWELT AKTUELL
UMW. PERSPEKT.	UMWELT PERSPEKTIVEN
UMWELTPSYCHOL.	UMWELTPSYCHOLOGIE
UMWELTRECHT PRAX.	UMWELTRECHT IN DER PRAXIS
UMWELTSCHUTZ SCHWEIZ	UMWELTSCHUTZ IN DER SCHWEIZ
UNASYLVA	UNASYLVA
UNION VILLES SUISSES FOCUS	UNION DES VILLES SUISSES, FOCUS
UNIPRESS	UNIPRESS
U.S. DEP. AGRIC. BULL.	UNITED STATES DEPARTMENT OF AGRICULTURE BULLETIN
U.S. DEP. AGRIC. MISC. PUBL.	UNITED STATES DEPARTMENT OF AGRICULTURE MISCELLANEOUS PUBLICATION
UNIV. ARIZ. BULL.	UNIVERSITY OF ARIZONA BULLETIN
UNSER WALD	UNSER WALD
UNTERTOGGENBURG. NEUJAHRSBL.	UNTERTOGGENBURGER NEUJAHRSBLÄTTER
URBAN ECOSYST.	URBAN ECOSYSTEMS
URBAN FOR. URBAN GREENING	URBAN FORESTRY AND URBAN GREENING
U.S. GEOL. SURV. PROF. PAP.	U.S. GEOLOGICAL SURVEY PROFESSIONAL PAPER
VADOSE ZONE J.	VADOSE ZONE JOURNAL
VDI BER.	VDI BERICHTE
VEG. HIST. ARCHAEOBOT.	VEGETATION HISTORY AND ARCHAEOBOTANY
VEGETATIO	VEGETATIO
VERH. DTSCH. ZOOL. GES.	VERHANDLUNGEN DER DEUTSCHEN ZOOLOGISCHEN GESELLSCHAFT
VERH. GES. ÖKOL.	VERHANDLUNGEN DER GESELLSCHAFT FÜR ÖKOLOGIE
VERH. INT. VER. THEORET. ANGEW. LIMNOL.	VERHANDLUNGEN DER INTERNATIONALEN VEREINIGUNG FÜR THEORETISCHE UND ANGEWANDTE LIMNOLOGIE
VERH. NAT.FORSCH. GES. BASEL	VERHANDLUNGEN DER NATURFORSCHENDEN GESELLSCHAFT IN BASEL
VERH. SCHWEIZ. NAT.FORSCH. GES.	VERHANDLUNGEN DER SCHWEIZERISCHEN NATURFORSCHENDEN GESELLSCHAFT
VERH. ZOOL.-BOT. GES. ÖSTERR.	VERHANDLUNGEN DER ZOOLOGISCH-BOTANISCHEN GESELLSCHAFT IN ÖSTERREICH
VERMESS. PHOTOGRAMM. KULT.TECH.	VERMESSUNG, PHOTOGRAMMETRIE, KULTURTECHNIK
VERÖFF. LANDESSTELLE NAT.SCHUTZ LANDSCH.PFL. BADEN-WÜRTT.	VERÖFFENTLICHUNGEN DER LANDESSTELLE FÜR NATURSCHUTZ UND LANDSCHAFTSPFLEGE IN BADEN-WÜRTTEMBERG
VERÖFF. GEOBOT. INST. EIDGENÖSS. TECH. HOCHSCH., STIFT. RÜBEL ZÜR.	VERÖFFENTLICHUNGEN DES GEOBOTANISCHEN INSTITUTES DER EIDG. TECHNISCHEN HOCHSCHULE, STIFTUNG RÜBEL IN ZÜRICH
VERÖFF. NIEDERSÄCHS. INST. LANDESKD. LANDESENTWICKL. UNIV. GÖTT.	VERÖFFENTLICHUNGEN DES NIEDERSÄCHSISCHEN INSTITUTS FÜR LANDESKUNDE UND LANDESENTWICKLUNG AN DER UNIVERSITÄT GÖTTINGEN
VERÖFF. NAT.SCHUTZ LANDSCH.PFL. BADEN-WÜRTT.	VERÖFFENTLICHUNGEN FÜR NATURSCHUTZ UND LANDSCHAFTSPFLEGE IN BADEN-WÜRTTEMBERG
VERÖFF. NAT.KD.MUS. LEIPZ.	VERÖFFENTLICHUNGEN NATURKUNDEMUSEUM LEIPZIG
VERÖFF. NAT.-MUS. LUZERN	VERÖFFENTLICHUNGEN NATUR-MUSEUM LUZERN
VERS.ANST. WASSERBAU HYDROL. GLAZIOL.	VERSUCHSANSTALT FÜR WASSERBAU, HYDROLOGIE UND GLAZIOLOGIE
VESPÈRE	VESPÈRE
VIERTELJAHRSSCHR. NAT.FORSCH. GES. ZÜR.	VIERTELJAHRSSCHRIFT DER NATURFORSCHENDEN GESELLSCHAFT IN ZÜRICH
VISUAL COMPUT.	VISUAL COMPUTER
VITIS	VITIS
VÖGEL HEIM.	VÖGEL DER HEIMAT
VOGELKDL. BER. NIEDERSACHS.	VOGELKUNDLICHE BERICHTE AUS NIEDERSACHSEN
VOGELKDL. BER. KÜSTE BINNENLAND	VOGELKUNDLICHE BERICHTE ZWISCHEN KÜSTE UND BINNENLAND
VOGELWARTE	VOGELWARTE
VOGELWELT	VOGELWELT
VOLKSWIRTSCHAFT	VOLKSWIRTSCHAFT
VORARLBERGER NAT.SCHAU	VORARLBERGER NATURSCHAU
WADER STUDY GROUP BULL.	WADER STUDY GROUP BULLETIN
WALD	WALD
WALDARBEIT	WALDARBEIT
WALD HOLZ	WALD UND HOLZ
WALD- HOLZWIRTSCH.	WALD- UND HOLZWIRTSCHAFT
WASSER ENERG. LUFT	WASSER, ENERGIE, LUFT
WASSER BODEN	WASSER UND BODEN
WASSER- ENERG.WIRTSCH.	WASSER- UND ENERGIEWIRTSCHAFT
WATER AIR SOIL POLLUT.	WATER, AIR AND SOIL POLLUTION
WATER ALTERN.	WATER ALTERNATIVES
WATER POLICY	WATER POLICY
WATER	WATER
WATER RES.	WATER RESEARCH
WATER RESOUR. BULL.	WATER RESOURCES BULLETIN
WATER RESOUR. RES.	WATER RESOURCES RESEARCH
WATER SCI. TECHNOL.	WATER SCIENCE AND TECHNOLOGY
WATER SERV.	WATER SERVICES
WEED RES.	WEED RESEARCH
WEST. J. APPL. FOR.	WESTERN JOURNAL OF APPLIED FORESTRY
WETLANDS	WETLANDS
WETTER LEBEN	WETTER UND LEBEN
WHAT'S NEW FOR. RES.	WHAT'S NEW IN FOREST RESEARCH
WIEN. SCHR. GEOGR. KARTOGR.	WIENER SCHRIFTEN ZUR GEOGRAPHIE UND KARTOGRAPHIE
WILDBACH- LAWINENVERBAU	WILDBACH- UND LAWINENVERBAU
WILDERNESS ENVIRON. MED.	WILDERNESS AND ENVIRONMENTAL MEDICINE
WILDFIRE	WILDFIRE
WILDL. BIOL.	WILDLIFE BIOLOGY
WILDL. MONOGR.	WILDLIFE MONOGRAPHS
WILDL. RES.	WILDLIFE RESEARCH
WILDL. SOC. BULL.	WILDLIFE SOCIETY BULLETIN
WILEY INTERDISCIP. REV. WATER	WILEY INTERDISCIPLINARY REVIEWS: WATER
WILSON BULL.	WILSON BULLETIN
WINDAHLIA	WINDAHLIA
WIND ENERGY	WIND ENERGY
WINTERBER. EIDGENÖSS. INST. SCHNEE- LAWINENFORSCH.	WINTERBERICHTE DES EIDG. INSTITUTES FÜR SCHNEE- UND LAWINENFORSCHUNG
WISS. ALP.VER.HEFT	WISSENSCHAFTLICHE ALPENVEREINSHEFTE
WISS. Z. ERNST-MORITZ-ARNDT-UNIV. GREIFSWALD	WISSENSCHAFTLICHE ZEITSCHRIFT DER ERNST-MORITZ-ARNDT-UNIVERSITÄT GREIFSWALD
WISS. Z. TECH. UNIV. DRESD., SEP.R. 5	WISSENSCHAFTLICHE ZEITSCHRIFT DER TECHNISCHEN UNIVERSITÄT DRESDEN, SEPARATREIHE 5
WIT TRANS. ECOL. ENVIRON.	WIT TRANSACTIONS ON ECOLOGY AND THE ENVIRONMENT
WIT TRANS. ENG. SCI.	WIT TRANSACTIONS ON ENGINEERING SCIENCES
WOOD FIBER SCI.	WOOD AND FIBER SCIENCE
WOOD RES.	WOOD RESEARCH
WOOD SCI. TECHNOL.	WOOD SCIENCE AND TECHNOLOGY
WORLD ARCHEOL.	WORLD ARCHAEOLOGY
WORLD LEIS.	WORLD LEISURE
WORLD RESOUR. REV.	WORLD RESOURCE REVIEW
WORLD WOOD	WORLD WOOD
WUHAN UNIV. J. NAT. SCI.	WUHAN UNIVERSITY JOURNAL OF NATURAL SCIENCES
YEARB. SOCIOECON. AGRIC.	YEARBOOK OF SOCIOECONOMICS IN AGRICULTURE
YEARB. ESTON. NAT. SOC.	YEARBOOK OF THE ESTONIAN NATURALIST SOCIETY
YEARB. R. VET. AGRIC. COLL. CPH.	YEARBOOK, ROYAL VETERINARY AND AGRICULTURAL COLLEGE, COPENHAGEN
ZEISS - INF.	ZEISS - INFORMATIONEN
Z. ARB.GEM. ÖSTERR. ENTOMOL.	ZEITSCHRIFT DER ARBEITSGEMEINSCHAFT ÖSTERREICHISCHER ENTOMOLOGEN
Z. DTSCH. GES. GEOWISS.	ZEITSCHRIFT DER DEUTSCHEN GESELLSCHAFT FÜR GEOWISSENSCHAFTEN
Z. AGRARGESCH. AGRARSOZIOL.	ZEITSCHRIFT FÜR AGRARGESCHICHTE UND AGRARSOZIOLOGIE
Z. ANGEW. ENTOMOL.	ZEITSCHRIFT FÜR ANGEWANDTE ENTOMOLOGIE
Z. FORST- JAGDWES.	ZEITSCHRIFT FÜR DAS FORST- UND JAGDWESEN
Z. FORSTGENET. FORSTPFLANZENZÜCHT.	ZEITSCHRIFT FÜR FORSTGENETIK UND FORSTPFLANZENZÜCHTUNG
Z. GEOMORPHOL.	ZEITSCHRIFT FÜR GEOMORPHOLOGIE
Z. GLETSCH.KD. GLAZIALGEOL.	ZEITSCHRIFT FÜR GLETSCHERKUNDE UND GLAZIALGEOLOGIE
Z. JAGDWISS.	ZEITSCHRIFT FÜR JAGDWISSENSCHAFT
Z. KMU ENTREP.	ZEITSCHRIFT FÜR KMU UND ENTREPRENEURSHIP
Z. KULT.TECH. FLURBEREINIG.	ZEITSCHRIFT FÜR KULTURTECHNIK UND FLURBEREINIGUNG
Z. MYKOL.	ZEITSCHRIFT FÜR MYKOLOGIE
Z. NAT.FORSCH.	ZEITSCHRIFT FÜR NATURFORSCHUNG
Z. ÖKOL. NAT.SCHUTZ	ZEITSCHRIFT FÜR ÖKOLOGIE UND NATURSCHUTZ
Z. PFLANZENERNÄHR. BODENKD.	ZEITSCHRIFT FÜR PFLANZENERNÄHRUNG UND BODENKUNDE
Z. PFLANZENKRANKH. PFLANZENSCHUTZ	ZEITSCHRIFT FÜR PFLANZENKRANKHEITEN UND PFLANZENSCHUTZ
Z. PHOTOGRAMM. FERNERKUND.	ZEITSCHRIFT FÜR PHOTOGRAMMETRIE UND FERNERKUNDUNG
Z. PHYTOTHER.	ZEITSCHRIFT FÜR PHYTOTHERAPIE
Z. PILZKD.	ZEITSCHRIFT FÜR PILZKUNDE
Z. SÄUGETIERKD.	ZEITSCHRIFT FÜR SÄUGETIERKUNDE
Z. SOZIOL.	ZEITSCHRIFT FÜR SOZIOLOGIE
Z. TIERPSYCHOL.	ZEITSCHRIFT FÜR TIERPSYCHOLOGIE
Z. UMWELTPOLIT. UMWELTR.	ZEITSCHRIFT FÜR UMWELTPOLITIK & UMWELTRECHT
Z. VGL. PHYSIOL.	ZEITSCHRIFT FÜR VERGLEICHENDE PHYSIOLOGIE
Z. WELTFORSTWIRTSCH.	ZEITSCHRIFT FÜR WELTFORSTWIRTSCHAFT
Z. WIRTSCH.GEOGR.	ZEITSCHRIFT FÜR WIRTSCHAFTSGEOGRAPHIE
Z. WISS. ZOOL.	ZEITSCHRIFT FÜR WISSENSCHAFTLICHE ZOOLOGIE
Z. ZELLFORSCH.	ZEITSCHRIFT FÜR ZELLFORSCHUNG
ZOOKEYS	ZOOKEYS
ZOOL. ANZ.	ZOOLOGISCHER ANZEIGER
ZOOL. GART. N.F.	ZOOLOGISCHER GARTEN N.F.
ZOOL. JAHRB. ABT. SYST.	ZOOLOGISCHES JAHRBUCH, ABTEILUNG FÜR SYSTEMATIK
ZOOMORPHOLOGY	ZOOMORPHOLOGY
ZÜCHTER	ZÜCHTER
ZUGER NACHR.	ZUGER NACHRICHTEN
ZUGER NEUJAHRSBL.	ZUGER NEUJAHRSBLATT
ZÜR. GEOGR. SCHR.	ZÜRCHER GEOGRAPHISCHE SCHRIFTEN
ZÜR. WALD	ZÜRCHER WALD